federal_state,administrative_district,district,verb,municipality,city,postal_code,area_m2,total_population,male_population,female_population,population_density_km2,municipality_type,rental_level,average_price_m2,price_index_housing_costs,longitude,latitude,Population_Difference,male_to_female_ratio
11,0,0,0,0,Berlin,10178,891.12,3755251,1843196,1912055,4214,1.0,4.0,4973.0,110.1,13.405538,52.51767,-68859,0.963986914602352
2,0,0,0,0,Hamburg,20095,755.09,1892122,925616,966506,2506,1.0,6.0,5148.44,109.1,9.99697,53.550678,-40890,0.9576929682795554
9,1,62,0,0,München,80331,310.7,1512491,736806,775685,4868,1.0,7.0,8748.5,110.5,11.575997,48.137683,-38879,0.9498778499004106
5,3,15,0,0,Köln,50667,405.02,1084831,526588,558243,2678,1.0,7.0,4033.56,110.4,6.957068,50.938107,-31655,0.9432953032998175
6,4,12,0,0,Frankfurt am Main,60311,248.31,773068,380566,392502,3113,1.0,6.0,4924.75,109.8,8.682433,50.11088,-11936,0.9695899638727955
8,1,11,0,0,Stuttgart,70173,207.33,632865,315634,317231,3052,1.0,6.0,4390.49,109.5,9.177734,48.775817,-1597,0.9949658135554218
5,1,11,0,0,Düsseldorf,40213,217.41,629047,303510,325537,2893,1.0,6.0,4494.83,110.4,6.780068,51.22422,-22027,0.9323364164442137
14,7,13,0,0,Leipzig,4109,297.8,616093,302741,313352,2069,1.0,6.0,2724.81,110.3,12.377931,51.338288,-10611,0.9661371237458194
5,9,13,0,0,Dortmund,44135,280.71,593317,290847,302470,2114,1.0,2.0,2224.41,110.4,7.464165,51.514171,-11623,0.9615730485668
5,1,13,0,0,Essen,45127,210.34,584580,284152,300428,2779,1.0,1.0,3179.0,110.4,7.012583,51.455843,-16276,0.9458239578201766
4,0,11,0,0,Bremen,28195,318.2,569396,280842,288554,1789,1.0,3.0,2819.0,113.0,8.809338,53.075606,-7712,0.9732736333580543
14,6,12,0,0,Dresden,1067,328.48,563311,279338,283973,1715,1.0,3.0,3342.25,110.3,13.736883,51.051697,-4635,0.983678025727798
3,2,41,1,1,Hannover,30159,204.3,545045,266093,278952,2668,1.0,4.0,3576.5,110.0,9.738084,52.374551,-12859,0.9539024635062663
9,5,64,0,0,Nürnberg,90403,186.44,523026,255250,267776,2805,1.0,3.0,4204.5,110.5,11.075269,49.450938,-12526,0.953222096080306
5,1,12,0,0,Duisburg,47051,232.84,502211,247892,254319,2157,1.0,5.0,1885.82,110.4,6.765477,51.433259,-6427,0.9747285888981948
5,9,11,0,0,Bochum,44787,145.66,365742,178377,187365,2511,1.0,5.0,2665.0,110.4,7.217177,51.482699,-8988,0.9520294612120727
5,1,24,0,0,Wuppertal,42275,168.39,358876,175788,183088,2131,1.0,3.0,2402.5,110.4,7.195874,51.271288,-7300,0.9601284628156952
5,7,11,0,0,Bielefeld,33602,258.83,338332,163149,175183,1307,1.0,3.0,2732.5,110.4,8.53212,52.020578,-12034,0.931306119886062
5,3,14,0,0,Bonn,53111,141.06,336465,160769,175696,2385,1.0,3.0,3626.67,110.4,7.099187,50.734245,-14927,0.9150407522083599
5,5,15,0,0,Münster,48143,303.28,320946,153935,167011,1058,1.0,3.0,4152.85,110.4,7.626804,51.961908,-13076,0.9217057559082935
8,2,22,0,0,Mannheim,68159,144.97,315554,157130,158424,2177,1.0,5.0,3771.5,109.5,8.466275,49.48778,-1294,0.991832045649649
8,2,12,0,0,Karlsruhe,76133,173.42,308707,157553,151154,1780,1.0,4.0,4436.5,109.5,8.405282,49.009626,6399,1.0423343080566838
9,7,61,0,0,Augsburg,86150,146.85,301033,148355,152678,2050,1.0,4.0,4689.0,110.5,10.897594,48.368384,-4323,0.9716855080627202
6,4,14,0,0,Wiesbaden,65183,203.87,283083,135153,147930,1389,1.0,5.0,4111.55,109.8,8.239138,50.081698,-12777,0.9136280673291421
5,1,16,0,0,Mönchengladbach,41061,170.47,268465,132961,135504,1575,1.0,4.0,2369.5,110.4,6.43161,51.194473,-2543,0.981233026331326
5,5,13,0,0,Gelsenkirchen,45879,104.94,263000,130545,132455,2506,1.0,2.0,3770.689734253363,110.4,7.096064,51.510892,-1910,0.9855800083047073
5,3,34,2,2,Aachen,52062,160.85,252136,131493,120643,1568,1.0,5.0,3511.0,110.4,6.0848,50.773516,10850,1.0899347662110523
3,1,1,0,0,Braunschweig,38100,192.7,251804,124770,127034,1307,1.0,2.0,2952.33638033193,110.0,10.520525,52.26249,-2264,0.9821779995906608
14,5,11,0,0,Chemnitz,9111,221.03,248563,122678,125885,1125,1.0,6.0,1947.99,110.3,12.921602,50.833593,-3207,0.974524367478254
1,0,2,0,0,Kiel,24103,118.65,247717,120149,127568,2088,1.0,3.0,3529.5,109.4,10.13727,54.321775,-7419,0.9418427818888749
15,0,2,0,0,Halle (Saale),6108,135.03,242083,116835,125248,1793,1.0,2.0,2900.454749694436,110.7,11.970666,51.482478,-8413,0.9328292667347982
15,0,3,0,0,Magdeburg,39104,201.04,239364,117729,121635,1191,1.0,4.0,2564.439597793782,110.7,11.632726,52.126248,-3906,0.9678875323714391
8,3,11,0,0,Freiburg im Breisgau,79098,153.04,236140,112382,123758,1543,1.0,4.0,5239.0,109.5,7.849877,47.994786,-11376,0.9080786696617592
5,1,14,0,0,Krefeld,47803,137.78,228426,111189,117237,1658,1.0,1.0,2759.5,110.4,6.56089,51.332637,-6048,0.9484121906906523
7,3,15,0,0,Mainz,55116,97.73,220552,107358,113194,2257,1.0,5.0,4401.136975520225,109.8,8.271855,50.001959,-5836,0.9484424969521352
1,0,3,0,0,Lübeck,23552,214.19,218095,104723,113372,1018,1.0,3.0,3749.59,109.4,10.683932,53.866269,-8649,0.9237113220195463
16,0,51,0,0,Erfurt,99084,269.91,214969,104205,110764,796,1.0,3.0,2845.13,110.9,11.027236,50.977122,-6559,0.940784009244881
5,1,19,0,0,Oberhausen,46045,77.09,210824,102910,107914,2735,1.0,6.0,2216.5,110.4,6.852291,51.470317,-5004,0.9536297422021239
13,0,3,0,0,Rostock,18055,181.36,209920,102800,107120,1157,1.0,4.0,2238.2046132348623,111.0,12.135993,54.088548,-4320,0.9596713965646004
6,6,11,0,0,Kassel,34117,106.79,204202,99986,104216,1912,1.0,6.0,2729.0,109.8,9.495199,51.314684,-4230,0.9594112228448607
5,9,14,0,0,Hagen,58095,160.45,189783,92810,96973,1183,1.0,4.0,2814.674582352709,110.4,7.467406,51.360171,-4163,0.9570705247852495
12,0,54,0,0,Potsdam,14469,188.24,185750,89442,96308,987,1.0,3.0,4842.96,110.7,13.05358,52.400355,-6866,0.9287078955019313
10,0,41,100,100,Saarbrücken,66111,167.52,181959,90445,91514,1086,1.0,2.0,2204.5,109.2,6.995542,49.236608,-1069,0.9883187271892825
5,9,15,0,0,Hamm,59065,226.43,180849,89104,91745,799,1.0,3.0,2332.6821583030323,110.4,7.816947,51.678312,-2641,0.9712136901193525
7,3,14,0,0,Ludwigshafen am Rhein,67059,77.43,174265,87539,86726,2251,1.0,3.0,3132.0,109.8,8.447899,49.483235,813,1.0093743514055762
3,4,3,0,0,Oldenburg (Oldenburg),26122,103.09,172830,82742,90088,1676,1.0,1.0,3346.3439562822605,110.0,8.212993,53.140025,-7346,0.9184575082141906
5,1,17,0,0,Mülheim an der Ruhr,45468,91.28,172404,83069,89335,1889,1.0,2.0,2896.0,110.4,6.88505,51.428107,-6266,0.9298595175463145
3,4,4,0,0,Osnabrück,49074,119.8,167366,80755,86611,1397,1.0,4.0,3408.321228431276,110.0,8.04205,52.27692,-5856,0.9323873410998603
5,3,16,0,0,Leverkusen,51373,78.87,165748,80681,85067,2102,1.0,3.0,3293.5,110.4,6.979767,51.03245,-4386,0.9484406409065795
8,2,21,0,0,Heidelberg,69117,108.83,162273,77561,84712,1491,1.0,2.0,5176.5,109.5,8.705543,49.410524,-7151,0.9155845688922467
6,4,11,0,0,Darmstadt,64283,122.07,162243,82530,79713,1329,1.0,4.0,3211.1445514705556,109.8,8.653838,49.872238,2817,1.035339279665801
5,1,22,0,0,Solingen,42651,89.54,160643,78038,82605,1794,1.0,4.0,2720.0,110.4,7.085665,51.171718,-4567,0.9447127897827008
9,3,62,0,0,Regensburg,93047,80.86,157443,76690,80753,1947,1.0,4.0,4395.262920833069,110.5,12.101745,49.015249,-4063,0.949686079774126
5,9,16,0,0,Herne,44623,51.42,157368,77053,80315,3060,1.0,4.0,2166.0,110.4,7.222793,51.540365,-3262,0.9593849218701364
5,7,74,32,32,Paderborn,33098,179.59,154755,77098,77657,862,1.0,1.0,2468.6973102036936,110.4,8.757301,51.719601,-559,0.9928016791789536
5,1,62,24,24,Neuss,41460,99.52,154139,74536,79603,1549,1.0,4.0,3591.0,110.4,6.691409,51.198873,-5067,0.9363466201022574
9,1,61,0,0,Ingolstadt,85049,133.35,141029,71308,69721,1058,1.0,5.0,3369.2553448827384,110.5,11.423387,48.76542,1587,1.0227621520058519
6,4,13,0,0,Offenbach am Main,63065,44.88,134170,66650,67520,2990,1.0,6.0,4991.129399569894,109.8,8.764442,50.105567,-870,0.9871149289099526
9,5,63,0,0,Fürth,90762,63.35,131433,64348,67085,2075,1.0,3.0,4005.0,110.5,10.989974,49.477384,-2737,0.9592010136394127
8,4,21,0,0,Ulm,89073,118.68,128928,63803,65125,1086,1.0,5.0,3735.371960079152,109.5,9.990402,48.398454,-1322,0.979700575815739
8,1,21,0,0,Heilbronn,74072,99.89,128334,64610,63724,1285,1.0,2.0,3784.5,109.5,9.217953,49.140428,886,1.0139037097482895
8,2,31,0,0,Pforzheim,75175,97.99,127849,62926,64923,1305,1.0,2.0,3841.3946879301366,109.5,8.699166,48.891285,-1997,0.9692404848820911
9,6,63,0,0,Würzburg,97070,87.6,127810,61008,66802,1459,1.0,2.0,3899.278072733723,110.5,9.93725,49.79393,-5794,0.9132660698781474
3,1,3,0,0,Wolfsburg,38440,204.62,125961,62441,63520,616,1.0,1.0,2807.0,110.0,10.784975,52.421938,-1079,0.9830132241813602
3,1,59,16,16,Göttingen,37083,117.02,118946,57751,61195,1016,1.0,4.0,3382.321228431276,110.0,9.935418,51.533337,-3444,0.9437208922297573
5,5,12,0,0,Bottrop,46236,100.61,118113,57364,60749,1174,1.0,5.0,2430.5,110.4,6.929939,51.523694,-3385,0.9442789181714926
8,4,15,61,61,Reutlingen,72764,87.04,117547,58044,59503,1350,1.0,6.0,3867.3643841288213,109.5,9.212006,48.49208,-1459,0.9754802278876695
9,5,62,0,0,Erlangen,91052,76.96,116562,57940,58622,1515,1.0,4.0,4638.0,110.5,11.003274,49.59508,-682,0.9883661424038757
4,0,12,0,0,Bremerhaven,27576,101.41,115468,57391,58077,1139,1.0,2.0,1349.9865347426967,113.0,8.578068,53.543032,-686,0.9881880951151059
7,1,11,0,0,Koblenz,56068,105.25,115268,56506,58762,1095,1.0,2.0,3247.1597033712096,109.8,7.597956,50.359516,-2256,0.9616078418025255
5,3,78,4,4,Bergisch Gladbach,51465,83.09,112712,53947,58765,1357,1.0,4.0,3618.0,110.4,7.130608,50.992244,-4818,0.9180124223602485
5,1,20,0,0,Remscheid,42853,74.52,112613,55709,56904,1511,1.0,4.0,3306.674582352709,110.4,7.194356,51.179878,-1195,0.9789997188246872
7,2,11,0,0,Trier,54290,117.06,112195,55489,56706,958,1.0,3.0,3239.0,109.8,6.638021,49.757603,-1217,0.9785384262688251
5,5,62,32,32,Recklinghausen,45657,66.5,111734,54083,57651,1680,1.0,4.0,3722.674582352709,110.4,7.197544,51.614576,-3568,0.9381103536799015
16,0,53,0,0,Jena,7743,114.77,111191,55301,55890,969,1.0,4.0,2267.6162747545022,110.9,11.591842,50.93006,-589,0.989461442118447
5,1,70,24,24,Moers,47441,67.64,105287,51101,54186,1557,1.0,2.0,3742.689734253363,110.4,6.628027,51.453559,-3085,0.9430664747351715
3,1,2,0,0,Salzgitter,38226,224.49,104548,51829,52719,466,1.0,4.0,1789.0,110.0,10.329208,52.153574,-890,0.9831180409340086
5,9,70,40,40,Siegen,57072,114.69,102560,50342,52218,894,1.0,4.0,2936.674582352709,110.4,8.024625,50.874559,-1876,0.9640736910643839
5,7,54,8,8,Gütersloh,33330,112.02,102393,50736,51657,914,1.0,1.0,2777.0,110.4,8.375587,51.907302,-921,0.9821708577733899
3,2,54,21,21,Hildesheim,31134,92.29,101858,48560,53298,1104,1.0,3.0,3370.328804381599,110.0,9.948181,52.150623,-4738,0.9111036061390672
6,4,35,14,14,Hanau,63450,76.28,101364,49942,51422,1329,1.0,4.0,3438.0,109.8,8.915189,50.135573,-1480,0.971218544591809
7,3,12,0,0,Kaiserslautern,67657,139.7,101228,50948,50280,725,1.0,3.0,2859.152127420879,109.8,7.768864,49.445456,668,1.013285600636436
12,0,52,0,0,Cottbus/Chóśebuz,3046,165.62,99515,48535,50980,601,0.5,4.0,1924.439597793782,110.7,14.335117,51.759345,-2445,0.9520400156924284
13,0,4,0,0,Schwerin,19053,130.52,98596,47203,51393,755,0.5,2.0,2586.0,111.0,11.414434,53.628545,-4190,0.9184713871538925
5,9,54,36,36,Witten,58452,72.4,95897,46562,49335,1325,0.5,3.0,2518.5,110.4,7.337177,51.438718,-2773,0.9437924394446133
8,1,16,19,19,Esslingen am Neckar,73728,46.43,94941,47619,47322,2045,0.5,2.0,4189.394687930137,109.5,9.309565,48.741347,297,1.006276150627615
8,1,18,48,48,Ludwigsburg,71638,43.34,94157,46349,47808,2173,0.5,3.0,4695.0,109.5,9.194347,48.889441,-1459,0.9694820950468541
6,5,31,5,5,Gießen,35390,72.61,94146,46117,48029,1297,0.5,3.0,3063.152127420879,109.8,8.674877,50.586195,-1912,0.9601907181078099
16,0,52,0,0,Gera,7545,152.18,93634,45174,48460,615,0.5,3.0,1841.6238507048256,110.9,12.080429,50.876147,-3286,0.9321914981427982
5,3,58,8,8,Düren,52349,85.0,93207,46014,47193,1097,0.5,3.0,2124.5,110.4,6.482964,50.801678,-1179,0.9750174814061408
8,4,16,41,41,Tübingen,72070,108.07,92811,43998,48813,859,0.5,3.0,3281.387111979806,109.5,9.054572,48.520863,-4815,0.9013582447298876
1,0,1,0,0,Flensburg,24937,56.73,92550,45874,46676,1631,0.5,2.0,2836.5,109.4,9.43751,54.78252,-802,0.9828177221698517
5,9,62,24,24,Iserlohn,58636,125.49,92540,45189,47351,737,0.5,3.0,2540.6821583030323,110.4,7.699212,51.374541,-2162,0.9543409854068552
8,3,26,5004,74,Villingen-Schwenningen,78050,165.53,88213,43380,44833,533,0.5,3.0,2895.387111979806,109.5,8.459649,48.058255,-1453,0.9675908371065955
5,1,58,28,28,Ratingen,40878,88.74,87388,42144,45244,985,0.5,2.0,3720.0,110.4,6.849646,51.297037,-3100,0.9314826275307223
14,5,24,330,330,Zwickau,8056,102.58,87172,42519,44653,850,0.5,3.0,2146.0938198226722,110.3,12.495641,50.718556,-2134,0.9522092580565695
5,9,78,24,24,Lünen,44532,59.39,86868,42222,44646,1463,0.5,1.0,3100.6973102036936,110.4,7.523533,51.614327,-2424,0.9457062222819513
8,3,35,5004,43,Konstanz,78462,54.12,85859,40927,44932,1586,0.5,5.0,6243.0,109.5,9.175957,47.662757,-4005,0.9108653075758925
7,3,19,0,0,Worms,67547,108.73,84646,41957,42689,778,0.5,2.0,2825.1597033712096,109.8,8.361704,49.629828,-732,0.9828527255264823
5,5,62,24,24,Marl,45768,87.76,84331,41267,43064,961,0.5,1.0,2169.0,110.4,7.101811,51.658211,-1797,0.958271409994427
5,7,70,24,24,Minden,32423,101.12,83076,40945,42131,822,0.5,3.0,2456.6821583030323,110.4,8.914559,52.288271,-1186,0.9718497068666777
5,1,58,32,32,Velbert,42551,74.9,82445,40346,42099,1101,0.5,2.0,2540.0,110.4,7.041629,51.340048,-1753,0.9583600560583386
1,0,60,63,63,Norderstedt,22846,58.1,81880,39705,42175,1409,0.5,3.0,3782.7987734994385,109.4,9.996943,53.706115,-2470,0.9414344991108476
9,4,61,0,0,Bamberg,96047,54.62,79935,39117,40818,1463,0.5,5.0,3776.0,110.5,10.886786,49.893387,-1701,0.9583272085844481
15,0,1,0,0,Dessau-Roßlau,6844,245.05,79655,38509,41146,325,0.5,6.0,1410.4244458931207,110.7,12.245715,51.834703,-2637,0.9359111456763719
1,0,4,0,0,Neumünster,24534,71.66,79502,39256,40246,1109,0.5,4.0,2249.5,109.4,9.988422,54.069895,-990,0.9754012821149928
3,4,1,0,0,Delmenhorst,27749,62.45,78385,38557,39828,1255,0.5,2.0,2670.33638033193,110.0,8.630108,53.049883,-1271,0.9680877774430049
5,1,66,32,32,Viersen,41747,91.1,78208,37833,40375,858,0.5,1.0,2381.0,110.4,6.389226,51.256856,-2542,0.9370402476780185
5,5,66,76,76,Rheine,48431,145.0,77893,38471,39422,537,0.5,2.0,2378.689734253363,110.4,7.438651,52.279214,-951,0.9758764141849728
6,5,34,14,14,Marburg,35037,123.91,77845,36720,41125,628,0.5,2.0,2555.1597033712096,109.8,8.769147,50.809004,-4405,0.892887537993921
3,3,55,22,22,Lüneburg,21335,70.5,76837,36847,39990,1090,0.5,7.0,3553.5,110.0,10.408793,53.249157,-3143,0.9214053513378344
5,5,62,12,12,Dorsten,46284,171.2,76720,37154,39566,448,0.5,4.0,2362.674582352709,110.4,6.964689,51.660837,-2412,0.9390385684678765
5,3,82,68,68,Troisdorf,53840,62.0,76251,37360,38891,1230,0.5,3.0,3226.5,110.4,7.162309,50.812544,-1531,0.9606335656064385
3,4,5,0,0,Wilhelmshaven,26382,107.11,76089,37268,38821,710,0.5,2.0,2194.33638033193,110.0,8.111156,53.520302,-1553,0.9599958785193581
5,5,62,14,14,Gladbeck,45964,35.97,75889,36808,39081,2110,0.5,3.0,3846.6821583030323,110.4,6.992723,51.573424,-2273,0.9418387451702873
9,2,61,0,0,Landshut,84028,65.83,75457,36833,38624,1146,0.5,5.0,4738.5,110.5,12.152143,48.536978,-1791,0.9536298674399337
5,7,66,20,20,Detmold,32756,129.39,75089,36239,38850,580,0.5,1.0,2182.6973102036936,110.4,8.878641,51.935357,-2611,0.9327927927927928
9,4,62,0,0,Bayreuth,95444,66.89,74506,36399,38107,1114,0.5,1.0,3206.0,110.5,11.575301,49.943752,-1708,0.9551788385336027
5,9,58,4,4,Arnsberg,59821,193.72,74323,36501,37822,384,0.5,3.0,2134.6821583030323,110.4,8.064801,51.395795,-1321,0.9650732377981069
5,5,62,4,4,Castrop-Rauxel,44575,51.68,73795,35946,37849,1428,0.5,5.0,2273.5,110.4,7.310311,51.548997,-1903,0.9497212607994927
12,0,51,0,0,Brandenburg an der Havel,14770,229.72,73609,36106,37503,320,0.5,3.0,1674.4471737441054,110.7,12.563364,52.408651,-1397,0.9627496466949311
9,6,61,0,0,Aschaffenburg,63739,62.45,72444,35160,37284,1160,0.5,3.0,3033.2704967833924,110.5,9.147832,49.973506,-2124,0.9430318635339556
5,5,54,8,8,Bocholt,46395,119.4,71930,35297,36633,602,0.5,3.0,2583.5,110.4,6.61564,51.837931,-1336,0.9635301504108318
5,9,62,32,32,Lüdenscheid,58507,87.02,71865,35208,36657,826,0.5,2.0,2590.689734253363,110.4,7.63358,51.21582,-1449,0.9604713970046649
3,3,51,6,6,Celle,29221,176.02,70138,33925,36213,398,0.5,3.0,2103.0,110.0,10.08067,52.626307,-2288,0.9368182696821583
9,7,63,0,0,Kempten (Allgäu),87435,63.28,70056,34669,35387,1107,0.5,6.0,3279.247768932408,110.5,10.317823,47.724016,-718,0.9797100630174923
6,6,31,9,9,Fulda,36037,104.05,69968,34533,35435,672,0.5,3.0,2828.0,109.8,9.675061,50.55323,-902,0.974544941442077
5,9,74,28,28,Lippstadt,59555,113.68,68890,33938,34952,606,0.5,1.0,2402.6973102036936,110.4,8.346206,51.674054,-1014,0.9709887846189059
8,1,36,5001,88,Aalen,73430,146.58,68816,34232,34584,469,0.5,3.0,3164.5,109.5,10.092337,48.835057,-352,0.989821882951654
5,1,70,8,8,Dinslaken,46535,47.66,67762,32721,35041,1422,0.5,3.0,3484.6821583030323,110.4,6.734967,51.562266,-2320,0.9337918438400731
5,7,58,12,12,Herford,32052,79.15,67459,33076,34383,852,0.5,3.0,2188.5,110.4,8.673516,52.115598,-1307,0.9619870284733735
6,4,33,12,12,Rüsselsheim am Main,65428,58.29,67277,33658,33619,1154,0.5,3.0,3259.152127420879,109.8,8.411404,49.994936,39,1.001160058300366
5,3,62,32,32,Kerpen,50171,113.98,67239,33055,34184,590,0.5,2.0,2764.5,110.4,6.694948,50.869982,-1129,0.96697285279663
7,1,38,45,45,Neuwied,56564,86.5,65986,32428,33558,763,0.5,5.0,3123.136975520225,109.8,7.459692,50.429018,-1130,0.9663269563144407
16,0,55,0,0,Weimar,99423,84.47,65620,31624,33996,777,0.5,4.0,2798.0,110.9,11.329741,50.980761,-2372,0.9302270855394752
5,1,62,4,4,Dormagen,41539,85.5,65147,32375,32772,762,0.5,2.0,3263.0,110.4,6.841963,51.093432,-397,0.9878860002441108
8,1,15,45,45,Sindelfingen,71063,50.83,64995,32342,32653,1279,0.5,2.0,3565.3946879301366,109.5,9.002211,48.709831,-311,0.9904756071417634
14,5,23,320,320,Plauen,8523,102.11,64763,31519,33244,634,0.5,4.0,1996.0862438723489,110.3,12.135285,50.496039,-1725,0.9481109373119961
5,1,62,8,8,Grevenbroich,41515,102.42,64596,31114,33482,631,0.5,2.0,2568.0,110.4,6.583331,51.091192,-2368,0.9292754315751747
9,1,63,0,0,Rosenheim,83022,37.22,64403,31922,32481,1730,0.5,2.0,3863.278072733723,110.5,12.128932,47.856358,-559,0.9827899387334134
13,0,71,107,107,Neubrandenburg,17033,86.12,63989,30896,33093,743,0.5,4.0,2290.2046132348623,111.0,13.25996,53.557345,-2197,0.9336113377451425
8,4,35,5002,16,Friedrichshafen,88045,69.93,62932,31068,31864,900,0.5,2.0,4491.5,109.5,9.479614,47.652205,-796,0.9750188300276174
5,5,62,20,20,Herten,45699,37.33,62473,30445,32028,1674,0.5,2.0,3402.689734253363,110.4,7.140236,51.59465,-1583,0.9505744973148496
5,3,62,8,8,Bergheim,50126,96.34,62376,30438,31938,647,0.5,3.0,2355.5,110.4,6.640252,50.955113,-1500,0.9530340033815518
8,1,36,5007,65,Schwäbisch Gmünd,73525,113.81,62325,30279,32046,548,0.5,1.0,2993.402263880467,109.5,9.796508,48.802384,-1767,0.9448605130125445
8,3,17,5010,96,Offenburg,77652,78.37,61670,30387,31283,787,0.5,1.0,3223.0,109.5,7.944214,48.469474,-896,0.9713582456925487
3,2,41,5,5,Garbsen,30827,79.49,61349,29828,31521,772,0.5,3.0,2708.328804381599,110.0,9.600191,52.426344,-1693,0.9462897750705879
5,1,70,48,48,Wesel,46483,122.56,61330,29727,31603,500,0.5,3.0,2135.0,110.4,6.617306,51.65733,-1876,0.9406385469733886
9,7,75,135,135,Neu-Ulm,89231,80.95,61043,30274,30769,754,0.5,4.0,3037.262920833069,110.5,9.998683,48.392999,-495,0.983912379342845
5,3,62,28,28,Hürth,50354,51.22,60969,29739,31230,1190,0.5,2.0,3112.689734253363,110.4,6.865451,50.869481,-1491,0.9522574447646494
5,9,78,36,36,Unna,59423,88.56,60892,29785,31107,688,0.5,3.0,2292.0,110.4,7.689932,51.534878,-1322,0.9575015269874948
5,1,58,20,20,Langenfeld (Rheinland),40764,41.15,59783,28983,30800,1453,0.5,3.0,3366.6821583030323,110.4,6.948927,51.107416,-1817,0.9410064935064935
5,3,66,16,16,Euskirchen,53879,139.49,59772,29501,30271,429,0.5,3.0,2469.0,110.4,6.786098,50.660933,-770,0.9745631132106637
13,0,75,39,39,Greifswald,17489,50.81,59691,28334,31357,1175,0.5,1.0,2590.227341085847,111.0,13.379627,54.09581,-3023,0.9035940938227509
13,0,73,88,88,Stralsund,18439,54.59,59363,28778,30585,1087,0.5,4.0,2614.2046132348623,111.0,13.089973,54.313975,-1807,0.9409187510217427
8,1,17,5005,26,Göppingen,73033,59.21,59053,29350,29703,997,0.5,2.0,3253.3946879301366,109.5,9.653964,48.703267,-353,0.9881156785509881
12,0,53,0,0,Frankfurt (Oder),15230,147.85,58230,28223,30007,394,0.5,1.0,2081.0,110.7,14.551151,52.344651,-1784,0.9405472056520146
3,2,52,6,6,Hameln,31785,102.53,57905,27598,30307,565,0.5,2.0,2598.33638033193,110.0,9.356316,52.104402,-2709,0.910614709473059
5,1,62,22,22,Meerbusch,40667,64.4,57422,27460,29962,892,0.5,3.0,4350.0,110.4,6.688437,51.265845,-2502,0.9164942260196248
8,2,11,0,0,Baden-Baden,76530,140.19,57025,27240,29785,407,0.5,3.0,4051.5,109.5,8.239951,48.761794,-2545,0.9145543058586537
14,6,26,110,110,Görlitz,2826,67.53,56574,27133,29441,838,0.5,2.0,1436.5,110.3,14.988035,51.155287,-2308,0.9216059237118305
3,4,54,32,32,Lingen (Ems),49809,176.19,56542,28135,28407,321,0.5,1.0,2297.3439562822605,110.0,7.316682,52.522295,-272,0.990424895272292
5,3,34,32,32,Stolberg (Rhld.),52222,98.48,56455,27891,28564,573,0.5,3.0,2394.6821583030323,110.4,6.223585,50.776783,-673,0.9764388741072679
5,3,82,56,56,Sankt Augustin,53757,34.22,56369,27581,28788,1647,0.5,4.0,3225.5,110.4,7.185259,50.77333,-1207,0.9580728081144921
8,1,19,79,79,Waiblingen,71332,42.75,56081,27403,28678,1312,0.5,2.0,3698.3946879301366,109.5,9.314525,48.83001,-1275,0.9555408326940512
5,3,34,12,12,Eschweiler,52249,75.75,56049,27521,28528,740,0.5,1.0,2178.5,110.4,6.266781,50.817431,-1007,0.9647013460459899
5,1,58,16,16,Hilden,40721,25.95,55815,26856,28959,2151,0.5,3.0,3993.6821583030323,110.4,6.933705,51.168245,-2103,0.9273800890914742
5,3,62,36,36,Pulheim,50259,72.15,55530,26755,28775,770,0.5,4.0,3842.0,110.4,6.800707,50.998416,-2020,0.9298001737619461
3,2,41,10,10,Langenhagen,30853,71.97,55367,27293,28074,769,0.5,4.0,2718.321228431276,110.0,9.734278,52.438469,-781,0.9721806653843413
3,4,56,15,15,Nordhorn,48529,149.86,55242,27191,28051,369,0.5,1.0,2069.0,110.0,7.071263,52.435804,-860,0.9693415564507504
6,4,34,1,1,Bad Homburg v. d. Höhe,61348,51.14,54996,26001,28995,1075,0.5,3.0,3311.152127420879,109.8,8.61299,50.228406,-2994,0.8967408173823073
5,7,66,8,8,Bad Salzuflen,32105,100.05,54808,26458,28350,548,0.5,5.0,2333.6670064023783,110.4,8.747019,52.084067,-1892,0.9332627865961199
9,6,62,0,0,Schweinfurt,97421,35.7,54675,27041,27634,1532,0.5,4.0,2752.5,110.5,10.230301,50.045505,-593,0.9785409278425129
5,9,54,16,16,Hattingen,45525,71.67,54637,26501,28136,762,0.5,2.0,2371.689734253363,110.4,7.184107,51.399035,-1635,0.9418893943702019
6,5,32,23,23,Wetzlar,35578,75.65,54187,26305,27882,716,0.5,5.0,2459.0,109.8,8.501069,50.554439,-1577,0.9434402123233627
7,3,16,0,0,Neustadt an der Weinstraße,67433,117.09,53981,26306,27675,461,0.5,2.0,2583.1597033712096,109.8,8.140755,49.351983,-1369,0.9505329719963866
9,2,62,0,0,Passau,94032,69.56,53907,26167,27740,775,0.5,3.0,3068.5,110.5,13.458449,48.572926,-1573,0.943294881038212
5,1,54,36,36,Kleve,47533,97.76,53388,26519,26869,546,0.5,3.0,2530.6821583030323,110.4,6.138858,51.787781,-350,0.9869738360192043
5,5,70,4,4,Ahlen,59227,123.13,53348,26078,27270,433,0.5,3.0,2092.0,110.4,7.889882,51.762985,-1192,0.9562889622295563
5,3,62,24,24,Frechen,50226,45.06,52811,25718,27093,1172,0.5,4.0,3193.674582352709,110.4,6.811192,50.909715,-1375,0.9492488834754365
3,1,58,37,37,Wolfenbüttel,38300,78.74,52681,25876,26805,669,0.5,3.0,2839.328804381599,110.0,10.536202,52.163491,-929,0.9653422868867748
7,1,33,6,6,Bad Kreuznach,55545,55.56,52529,25028,27501,945,0.5,2.0,2760.0,109.8,7.861839,49.844515,-2473,0.9100759972364642
5,9,62,40,40,Menden (Sauerland),58706,86.1,52485,25605,26880,610,0.5,5.0,2555.6670064023783,110.4,7.795344,51.439281,-1275,0.9525669642857143
5,5,66,28,28,Ibbenbüren,49477,108.87,52421,25823,26598,482,0.5,3.0,2269.0,110.4,7.714734,52.275364,-775,0.9708624708624709
5,3,74,12,12,Gummersbach,51643,95.41,52001,25648,26353,545,0.5,5.0,2715.6670064023783,110.4,7.568149,51.028326,-705,0.9732478275718135
8,4,36,5005,64,Ravensburg,88212,92.05,51482,25531,25951,559,0.5,3.0,4130.5,109.5,9.615089,47.78366,-420,0.9838156525760087
8,1,15,3,3,Böblingen,71032,39.04,51460,25531,25929,1318,0.5,4.0,3690.3795360294826,109.5,9.009663,48.685296,-398,0.9846503914535848
3,1,57,6,6,Peine,31224,119.84,51411,25326,26085,429,0.5,3.0,1951.5,110.0,10.227076,52.321764,-759,0.9709028177113284
7,3,18,0,0,Speyer,67346,42.71,51368,25130,26238,1203,0.5,1.0,3236.1672793215403,109.8,8.436572,49.316172,-1108,0.9577711715831999
8,2,16,5005,43,Rastatt,76437,58.98,51310,25572,25738,870,0.5,3.0,3219.0,109.5,8.202529,48.857703,-166,0.9935503924158832
1,0,56,15,15,Elmshorn,25335,21.36,50772,24873,25899,2377,0.5,2.0,4529.806349449769,109.4,9.655259,53.754958,-1026,0.9603845708328507
3,4,2,0,0,Emden,26721,112.34,50535,25071,25464,450,0.5,3.0,1810.0,110.0,7.205946,53.370558,-393,0.9845664467483506
3,1,53,17,17,Goslar,38640,163.88,50203,24647,25556,306,0.5,2.0,2373.33638033193,110.0,10.429312,51.906508,-909,0.9644310533729848
5,1,66,36,36,Willich,47877,67.8,50144,24436,25708,740,0.5,2.0,2988.0,110.4,6.550043,51.262542,-1272,0.9505212385249727
8,1,35,5002,19,Heidenheim an der Brenz,89522,107.09,50025,24891,25134,467,0.5,2.0,3050.3946879301366,109.5,10.154639,48.677736,-243,0.9903318214370972
5,3,62,20,20,Erftstadt,50374,119.89,49882,24145,25737,416,0.5,5.0,2873.5,110.4,6.811853,50.812197,-1592,0.9381435287718072
8,3,36,5003,50,Lörrach,79539,39.37,49876,24248,25628,1267,0.5,4.0,3769.3795360294826,109.5,7.659191,47.612096,-1380,0.9461526455439363
5,5,54,20,20,Gronau (Westf.),48599,78.82,49824,24952,24872,632,0.5,1.0,2336.6973102036936,110.4,7.019103,52.212285,80,1.003216468317787
8,1,15,28,28,Leonberg,71229,48.73,49512,24601,24911,1016,0.5,1.0,4635.0,109.5,9.016776,48.800497,-310,0.9875556982858978
5,7,54,28,28,Rheda-Wiedenbrück,33378,86.72,49486,24707,24779,571,0.5,1.0,2040.6973102036936,110.4,8.293327,51.855343,-72,0.9970943137334033
5,7,70,4,4,Bad Oeynhausen,32545,64.83,49477,24248,25229,763,0.5,3.0,2051.5,110.4,8.805514,52.205258,-981,0.9611161758294027
8,3,35,5005,75,Singen (Hohentwiel),78224,61.77,49441,24039,25402,800,0.5,4.0,3343.3795360294826,109.5,8.835117,47.759711,-1363,0.9463428076529408
9,1,78,124,124,Freising,85354,88.59,49339,24807,24532,557,0.5,5.0,6156.0,110.5,11.748361,48.403627,275,1.0112098483613239
5,9,78,4,4,Bergkamen,59192,44.9,49263,24424,24839,1097,0.5,3.0,2967.6821583030323,110.4,7.643344,51.615888,-415,0.9832924030758082
9,2,63,0,0,Straubing,94315,67.59,49164,24797,24367,727,0.5,5.0,3156.2553448827384,110.5,12.56951,48.881802,430,1.0176468174169984
8,3,17,5007,65,Lahr/Schwarzwald,77933,69.84,49074,24616,24458,703,0.5,5.0,3101.371960079152,109.5,7.874292,48.339132,158,1.0064600539700712
7,3,11,0,0,Frankenthal (Pfalz),67227,43.88,49051,23923,25128,1118,0.5,4.0,3259.1445514705556,109.8,8.354282,49.535556,-1205,0.9520455269022604
5,3,82,12,12,Bornheim,53332,82.69,49025,23832,25193,593,0.5,2.0,3332.5,110.4,6.990342,50.762547,-1361,0.945977057119041
5,9,74,40,40,Soest,59494,85.81,48607,23745,24862,566,0.5,3.0,2508.6821583030323,110.4,8.106308,51.572543,-1117,0.9550719974257904
3,3,52,11,11,Cuxhaven,27474,161.93,48562,22980,25582,300,0.5,2.0,2957.5,110.0,8.69747,53.864463,-2602,0.8982878586506137
3,3,59,38,38,Stade,21682,110.07,48353,23523,24830,439,0.5,2.0,2337.33638033193,110.0,9.475977,53.601302,-1307,0.9473620620217479
5,3,34,4,4,Alsdorf,52477,31.68,48328,23877,24451,1526,0.5,1.0,2111.0,110.4,6.161607,50.874052,-574,0.9765244775264815
9,1,74,115,115,Dachau,85221,34.96,48195,23573,24622,1379,0.5,3.0,3801.2704967833924,110.5,11.437493,48.263327,-1049,0.9573958248720656
5,3,82,20,20,Hennef (Sieg),53773,105.89,48002,23294,24708,453,0.5,3.0,2651.6821583030323,110.4,7.282575,50.775911,-1414,0.9427715719604987
12,0,65,256,256,Oranienburg,16515,163.69,47752,23208,24544,292,0.5,2.0,3295.5,110.7,13.236623,52.754051,-1336,0.9455671447196871
7,3,13,0,0,Landau in der Pfalz,76829,82.94,47610,22627,24983,574,0.5,3.0,2886.152127420879,109.8,8.112414,49.196595,-2356,0.9056958731937718
5,5,58,16,16,Dülmen,48249,184.83,47468,23146,24322,257,0.5,1.0,2436.5,110.4,7.279146,51.828537,-1176,0.9516487130992517
3,4,59,24,24,Melle,49324,253.95,47228,23416,23812,186,0.5,3.0,2247.328804381599,110.0,8.335672,52.201721,-396,0.983369729548127
6,4,34,8,8,Oberursel (Taunus),61440,45.34,47042,22792,24250,1038,0.5,2.0,5043.0,109.8,8.582282,50.200588,-1458,0.9398762886597938
5,3,34,16,16,Herzogenrath,52134,33.38,46941,22674,24267,1406,0.5,2.0,3160.689734253363,110.4,6.089184,50.865711,-1593,0.9343552973173446
10,0,43,114,114,Neunkirchen,66538,75.26,46882,23094,23788,623,0.5,4.0,1630.5,109.2,7.178148,49.345482,-694,0.970825626366235
5,9,78,28,28,Schwerte,58239,56.23,46658,22873,23785,830,0.5,3.0,2757.6821583030323,110.4,7.568982,51.441141,-912,0.9616565062013874
9,4,64,0,0,Hof,95028,58.02,46656,22663,23993,804,0.5,1.0,1590.0,110.5,11.913545,50.316521,-1330,0.9445671654232485
8,2,15,5003,9,Bruchsal,76646,93.04,46587,23342,23245,501,0.5,3.0,2807.387111979806,109.5,8.5977,49.125785,97,1.004172940417294
6,4,38,11,11,Rodgau,63110,65.04,46426,23095,23331,714,0.5,1.0,2821.1672793215403,109.8,8.88533,50.024355,-236,0.9898847027559898
8,4,17,5001,79,Albstadt,72458,134.4,46422,23028,23394,345,0.5,2.0,2054.5,109.5,9.026328,48.214156,-366,0.9843549628109771
8,1,16,77,77,Filderstadt,70794,38.55,46188,22904,23284,1198,0.5,2.0,3544.3946879301366,109.5,9.21973,48.67876,-380,0.9836797801065109
5,7,58,4,4,Bünde,32257,59.3,46030,22389,23641,776,0.5,2.0,1876.5,110.4,8.58371,52.197547,-1252,0.9470411573114504
16,0,67,29,29,Gotha,99867,69.58,46019,22660,23359,661,0.5,5.0,3045.6086988041716,110.9,10.70337,50.948759,-699,0.9700757737916863
8,1,19,20,20,Fellbach,70734,27.71,45896,22275,23621,1656,0.5,2.0,4794.5,109.5,9.278375,48.80685,-1346,0.9430168070784472
9,7,64,0,0,Memmingen,87700,70.11,45857,22647,23210,654,0.5,6.0,2906.247768932408,110.5,10.181558,47.984959,-563,0.9757432141318397
9,7,62,0,0,Kaufbeuren,87600,40.02,45792,22583,23209,1144,0.5,5.0,3434.5,110.5,10.620583,47.879698,-626,0.9730277047697015
15,0,91,375,375,Wittenberg,6886,240.7,45535,21990,23545,189,0.5,3.0,1919.4471737441054,110.7,12.645554,51.867003,-1555,0.9339562539817371
8,2,26,96,96,Weinheim,69469,58.11,45275,22022,23253,779,0.5,1.0,3571.5,109.5,8.670732,49.550558,-1231,0.9470605943319141
3,2,41,12,12,Neustadt am Rübenberge,31535,358.96,45262,22350,22912,126,0.5,3.0,1895.3288043815992,110.0,9.457529,52.504751,-562,0.9754713687150838
3,2,41,11,11,Lehrte,31275,127.67,44823,22324,22499,351,0.5,3.0,2407.0,110.0,9.976958,52.372615,-175,0.9922218765278457
12,0,63,80,80,Falkensee,14612,43.34,44806,21989,22817,1034,0.5,2.0,2507.454749694436,110.7,13.095729,52.562932,-828,0.9637112679142744
5,3,62,12,12,Brühl,50321,36.12,44804,21329,23475,1240,0.5,4.0,3297.674582352709,110.4,6.902458,50.82949,-2146,0.9085835995740149
8,4,16,5003,36,Rottenburg am Neckar,72108,142.27,44653,22047,22606,314,0.5,2.0,3234.0,109.5,8.936507,48.479475,-559,0.9752720516676988
1,0,56,39,39,Pinneberg,25421,21.54,44279,21634,22645,2056,0.5,2.0,4272.806349449769,109.4,9.793233,53.660754,-1011,0.9553543828659748
5,1,62,16,16,Kaarst,41564,37.39,44253,21159,23094,1184,0.5,1.0,3426.5,110.4,6.614471,51.231804,-1935,0.9162120031176929
5,3,70,4,4,Erkelenz,41812,117.34,44215,21626,22589,377,0.5,4.0,2391.674582352709,110.4,6.314104,51.078671,-963,0.9573686307494799
13,0,74,87,87,Wismar,23966,41.73,43878,21243,22635,1051,0.5,4.0,2788.0,111.0,11.466024,53.891577,-1392,0.9385023194168324
5,1,58,4,4,Erkrath,40699,26.88,43856,20950,22906,1632,0.5,3.0,3541.6821583030323,110.4,6.913114,51.218566,-1956,0.9146075264122937
8,1,18,5002,79,Bietigheim-Bissingen,74321,31.29,43755,21540,22215,1398,0.5,5.0,4633.5,109.5,9.132652,48.948358,-675,0.9696151249155975
12,0,60,20,20,Bernau bei Berlin,16321,104.19,43685,21249,22436,419,0.5,3.0,1961.4471737441054,110.7,13.587912,52.678368,-1187,0.9470939561419148
3,1,51,9,9,Gifhorn,38518,105.4,43625,21345,22280,414,0.5,2.0,2502.33638033193,110.0,10.54687,52.484369,-935,0.9580341113105925
5,5,54,12,12,Borken,46325,153.24,43489,21407,22082,284,0.5,6.0,2286.0,110.4,6.858415,51.843222,-675,0.9694321166561
5,3,70,16,16,Heinsberg,52525,92.21,43476,21467,22009,471,0.5,3.0,2546.6821583030323,110.4,6.094538,51.061906,-542,0.9753737107546913
5,1,66,16,16,Nettetal,41334,83.87,43095,21214,21881,514,0.5,2.0,2293.5,110.4,6.275553,51.30812,-667,0.9695169324985147
5,9,78,20,20,Kamen,59174,40.95,43058,21047,22011,1051,0.5,4.0,3016.674582352709,110.4,7.662404,51.592335,-964,0.9562037163236563
9,3,63,0,0,Weiden i.d.OPf.,92637,70.57,43052,20833,22219,610,0.5,7.0,3177.240192982077,110.5,12.160209,49.676076,-1386,0.9376209550384805
5,1,58,26,26,Monheim am Rhein,40789,23.05,43050,20692,22358,1868,0.5,4.0,3488.5,110.4,6.884614,51.091702,-1666,0.9254852849092048
3,4,52,1,1,Aurich,26603,197.29,42970,21176,21794,218,0.5,3.0,2035.3288043815992,110.0,7.482377,53.469895,-618,0.971643571625218
3,2,41,9,9,Laatzen,30880,34.16,42675,20476,22199,1249,0.5,2.0,3025.5,110.0,9.788174,52.314795,-1723,0.9223838911662687
9,3,61,0,0,Amberg,92224,50.13,42534,20920,21614,848,0.5,3.0,3165.2704967833924,110.5,11.856142,49.445278,-694,0.9678911816415287
16,0,63,105,105,Eisenach,99817,104.17,42408,20848,21560,407,0.5,3.0,1712.5,110.9,10.322388,50.977287,-712,0.9669758812615955
10,0,45,114,114,Homburg,66424,82.61,42297,20597,21700,512,0.5,4.0,3382.6145205884022,109.2,7.340244,49.3237,-1103,0.9491705069124424
6,4,38,2,2,Dreieich,63303,53.27,42260,20755,21505,793,0.5,2.0,2969.1597033712096,109.8,8.69546,50.017689,-750,0.9651243896768193
9,5,61,0,0,Ansbach,91522,99.91,42221,20194,22027,423,0.5,2.0,2715.5,110.5,10.577254,49.303682,-1833,0.9167839469741681
6,4,31,2,2,Bensheim,64625,57.83,42089,20706,21383,728,0.5,1.0,2828.1672793215403,109.8,8.622171,49.680002,-677,0.9683393349857363
5,3,82,60,60,Siegburg,53721,23.66,42049,20683,21366,1777,0.5,4.0,3538.0,110.4,7.2049,50.796665,-683,0.9680333239726668
8,1,16,5001,33,Kirchheim unter Teck,73230,40.47,41907,20667,21240,1036,0.5,2.0,3326.3946879301366,109.5,9.453784,48.646093,-573,0.9730225988700565
8,1,27,5009,76,Schwäbisch Hall,74523,104.19,41898,20400,21498,402,0.5,2.0,3025.0,109.5,9.735145,49.112856,-1098,0.948925481440134
9,4,63,0,0,Coburg,96450,48.29,41842,20328,21514,866,0.5,7.0,3403.240192982077,110.5,10.964232,50.258421,-1186,0.9448731058845403
3,2,41,21,21,Wunstorf,31515,125.74,41689,20206,21483,332,0.5,5.0,2395.313652480945,110.0,9.424195,52.425436,-1277,0.9405576502350695
5,3,82,24,24,Königswinter,53639,76.2,41495,20100,21395,545,0.5,4.0,3246.5,110.4,7.191597,50.676869,-1295,0.9394718392147698
12,0,60,52,52,Eberswalde,16225,93.62,41461,20243,21218,443,0.5,3.0,1998.4471737441054,110.7,13.820369,52.834577,-975,0.9540484494297294
8,1,16,5005,49,Nürtingen,72622,46.88,41403,20652,20751,883,0.5,2.0,3815.5,109.5,9.343281,48.625847,-99,0.9952291455833454
9,1,79,123,123,Germering,82110,21.61,41355,20044,21311,1914,0.5,2.0,4247.278072733723,110.5,11.364874,48.130916,-1267,0.9405471352822486
16,0,62,41,41,Nordhausen,99734,108.24,41339,20284,21055,382,0.5,1.0,2569.639002605487,110.9,10.791619,51.500441,-771,0.9633816195677987
5,3,70,20,20,Hückelhoven,41836,61.27,41301,20375,20926,674,0.5,6.0,2024.5,110.4,6.226269,51.05634,-551,0.9736691197553283
9,5,65,0,0,Schwabach,91126,40.8,41227,20110,21117,1010,0.5,3.0,3254.2704967833924,110.5,11.024451,49.328888,-1007,0.9523133020788938
3,3,59,10,10,Buxtehude,21614,76.69,40919,20203,20716,534,0.5,2.0,3173.0,110.0,9.698611,53.475851,-513,0.9752365321490635
3,3,53,5,5,Buchholz in der Nordheide,21244,74.76,40810,19492,21318,546,0.5,1.0,2379.3439562822605,110.0,9.881469,53.329257,-1826,0.9143446852425181
9,3,73,147,147,Neumarkt i.d.OPf.,92318,79.01,40808,19931,20877,516,0.5,1.0,2932.2856486840537,110.5,11.45894,49.279417,-946,0.9546869760980984
7,3,17,0,0,Pirmasens,66953,61.35,40682,19921,20761,663,0.5,3.0,1350.0,109.8,7.606009,49.19945,-840,0.9595395212176677
5,7,66,44,44,Lemgo,32657,100.85,40594,19978,20616,403,0.5,1.0,1999.6973102036936,110.4,8.900886,52.027912,-638,0.9690531625921615
14,5,22,180,180,Freiberg,9599,48.31,40485,20291,20194,838,0.5,1.0,1654.5,110.3,13.344344,50.914868,97,1.0048034069525602
15,0,85,135,135,Halberstadt,38820,142.97,40457,20617,19840,283,0.5,3.0,2144.4471737441054,110.7,11.04731,51.896112,777,1.0391633064516128
8,1,16,78,78,Leinfelden-Echterdingen,70771,29.89,40420,19927,20493,1352,0.5,5.0,5016.0,109.5,9.138976,48.693719,-566,0.9723808129605231
6,4,36,7,7,Hofheim am Taunus,65719,57.43,40371,19741,20630,703,0.5,2.0,2912.1597033712096,109.8,8.446053,50.088576,-889,0.956907416383907
5,7,58,24,24,Löhne,32584,59.51,40265,19738,20527,677,0.5,5.0,1803.5,110.4,8.688425,52.189912,-789,0.9615628197008818
5,5,54,4,4,Ahaus,48683,151.24,40245,20129,20116,266,0.5,1.0,1967.6973102036936,110.4,7.005037,52.076104,13,1.0006462517399086
8,1,19,5003,67,Schorndorf,73614,56.83,40204,19803,20401,707,0.5,2.0,3939.5,109.5,9.528152,48.805051,-598,0.9706877113866967
10,0,41,519,519,Völklingen,66333,67.1,40192,19561,20631,599,0.5,1.0,3516.637248439387,109.2,6.85431,49.249592,-1070,0.948136299743105
6,4,35,19,19,Maintal,63477,32.41,39815,19644,20171,1228,0.5,5.0,3480.136975520225,109.8,8.843408,50.139416,-527,0.97387338257895
8,1,16,80,80,Ostfildern,73760,22.81,39806,19651,20155,1745,0.5,3.0,4796.5,109.5,9.301248,48.712327,-504,0.9749937980649963
8,2,15,17,17,Ettlingen,76275,56.75,39699,19319,20380,700,0.5,3.0,3161.387111979806,109.5,8.405904,48.942,-1061,0.9479391560353287
14,6,28,110,110,Freital,1705,40.46,39558,19234,20324,978,0.5,3.0,2208.0,110.3,13.64812,50.997194,-1090,0.9463688250344421
6,4,38,9,9,Neu-Isenburg,63263,24.29,39287,19210,20077,1617,0.5,2.0,3712.1597033712096,109.8,8.6953,50.054636,-867,0.9568162574089755
5,3,82,44,44,Niederkassel,53859,35.79,39281,19348,19933,1098,0.5,4.0,3382.5,110.4,7.037503,50.811921,-585,0.970651683138514
6,4,38,6,6,Langen (Hessen),63225,29.12,39217,19335,19882,1347,0.5,2.0,3460.1597033712096,109.8,8.679424,49.989495,-547,0.9724876772960467
5,1,58,24,24,Mettmann,40822,42.56,39134,18801,20333,920,0.5,3.0,3193.0,110.4,6.978743,51.251915,-1532,0.9246545025328284
16,0,70,29,29,Ilmenau,98693,198.69,39127,20153,18974,197,0.5,4.0,2419.6162747545022,110.9,10.915563,50.688839,1179,1.062137662063877
15,0,90,535,535,Stendal,39576,268.3,39105,18954,20151,146,0.5,3.0,1509.0,110.7,11.861717,52.610601,-1197,0.9405984814649397
14,6,28,5229,270,Pirna,1796,53.06,39054,18904,20150,736,0.5,5.0,1968.0786679220182,110.3,14.009953,50.935414,-1246,0.9381637717121588
15,0,84,550,550,Weißenfels,6667,113.57,39041,19185,19856,344,0.5,4.0,1353.5,110.7,11.966732,51.200338,-671,0.9662066881547139
12,0,61,260,260,Königs Wusterhausen,15711,96.04,38929,19097,19832,405,0.5,5.0,2153.4320218434514,110.7,13.624464,52.299444,-735,0.9629386849536103
5,1,70,20,20,Kamp-Lintfort,47475,63.14,38665,18931,19734,612,0.5,4.0,2789.674582352709,110.4,6.55139,51.500257,-803,0.9593088071348941
5,3,34,36,36,Würselen,52146,34.39,38598,18841,19757,1122,0.5,5.0,2636.0,110.4,6.13022,50.821466,-916,0.9536366857316394
3,4,54,41,41,Papenburg,26871,118.44,38556,19515,19041,326,0.5,2.0,2134.33638033193,110.0,7.393067,53.078104,474,1.024893650543564
5,5,66,12,12,Greven,48268,140.26,38207,18808,19399,272,0.5,3.0,2656.5,110.4,7.613202,52.092652,-591,0.9695345120882519
5,3,62,40,40,Wesseling,50389,23.37,38192,18921,19271,1634,0.5,4.0,3579.674582352709,110.4,6.979971,50.824083,-350,0.9818379949146385
8,3,17,57,57,Kehl,77694,75.07,38154,18921,19233,508,0.5,5.0,2826.5,109.5,7.813177,48.572447,-312,0.9837778817657151
14,6,25,20,20,Bautzen / Budyšin,2625,66.67,38140,18483,19657,572,0.5,3.0,1672.0938198226722,110.3,14.427688,51.180868,-1174,0.9402757287480287
5,5,62,16,16,Haltern am See,45721,159.03,38117,18449,19668,240,0.5,3.0,2708.0,110.4,7.187214,51.743737,-1219,0.9380211511083995
8,1,19,5001,8,Backnang,71522,39.38,37957,18902,19055,964,0.5,1.0,3190.402263880467,109.5,9.424452,48.94691,-153,0.9919706113880871
15,0,82,15,15,Bitterfeld-Wolfen,6766,87.03,37894,18387,19507,435,0.5,2.0,1391.0,110.7,12.325417,51.625079,-1120,0.9425847131798841
9,1,79,121,121,Fürstenfeldbruck,82256,32.52,37695,18365,19330,1159,0.5,1.0,3532.2856486840537,110.5,11.253092,48.182775,-965,0.9500775995861356
5,5,70,52,52,Warendorf,48231,176.88,37616,18319,19297,213,0.5,2.0,2621.0,110.4,7.988499,51.950713,-978,0.9493185469243924
8,3,27,5006,50,Tuttlingen,78532,90.45,37458,18859,18599,414,0.5,1.0,2719.402263880467,109.5,8.818761,47.983725,260,1.013979246196032
5,5,70,8,8,Beckum,59269,111.46,37333,18496,18837,335,0.5,2.0,1999.0,110.4,8.042672,51.75574,-341,0.9818973297234167
3,4,53,4,4,Cloppenburg,49661,70.86,37056,18288,18768,523,0.5,3.0,2651.328804381599,110.0,8.042518,52.848368,-480,0.9744245524296675
5,5,58,12,12,Coesfeld,48653,141.36,37030,18256,18774,262,0.5,3.0,2528.0,110.4,7.166744,51.944948,-518,0.9724086502609992
16,0,54,0,0,Suhl,98527,141.62,37009,18339,18670,261,0.5,6.0,2566.601122853841,110.9,10.68693,50.609536,-331,0.9822710230316015
9,1,77,117,117,Erding,85435,54.61,36813,17749,19064,674,0.5,1.0,3133.2856486840537,110.5,11.907169,48.306323,-1315,0.931021821233739
8,2,26,5008,85,Sinsheim,74889,126.99,36601,18207,18394,288,0.5,1.0,2783.5,109.5,8.878701,49.252996,-187,0.9898336414048059
5,7,70,32,32,Porta Westfalica,32457,105.22,36374,18132,18242,346,0.5,4.0,2080.674582352709,110.4,8.914539,52.22962,-110,0.9939699594342726
5,5,66,8,8,Emsdetten,48282,72.06,36354,17979,18375,504,0.5,2.0,2453.5,110.4,7.527511,52.172195,-396,0.9784489795918367
3,3,53,40,40,Winsen (Luhe),21423,109.77,36295,17873,18422,331,0.5,2.0,2174.33638033193,110.0,10.209159,53.362425,-549,0.9701986754966887
16,0,64,46,46,Mühlhausen/Thüringen,99974,130.71,36226,17570,18656,277,0.5,2.0,2545.6314266551562,110.9,10.458418,51.209777,-1086,0.9417881646655232
5,1,70,44,44,Voerde (Niederrhein),46562,53.49,36196,17691,18505,677,0.5,6.0,2950.6594304520477,110.4,6.684946,51.595566,-814,0.9560118886787354
3,4,54,35,35,Meppen,49716,188.4,36117,17961,18156,192,0.5,3.0,1987.0,110.0,7.291674,52.690751,-195,0.9892597488433575
6,5,33,9,9,Limburg a. d. Lahn,65549,45.16,36053,17719,18334,798,0.5,1.0,2884.1672793215403,109.8,8.064098,50.387254,-615,0.9664557652449002
7,3,39,30,30,Ingelheim am Rhein,55218,73.31,36002,17630,18372,491,0.5,4.0,3667.0,109.8,8.056342,49.974439,-742,0.959612453733943
8,1,27,5002,14,Crailsheim,74564,109.08,35760,18082,17678,328,0.5,4.0,2788.3795360294826,109.5,10.071139,49.135752,404,1.022853263943885
6,4,40,3,3,Bad Vilbel,61118,25.68,35758,17447,18311,1392,0.5,5.0,4847.0,109.8,8.741149,50.180878,-864,0.9528152476653378
3,4,57,13,13,Leer (Ostfriesland),26789,70.11,35663,17935,17728,509,0.5,3.0,2396.328804381599,110.0,7.451416,53.22947,207,1.0116764440433212
5,7,66,40,40,Lage,32791,76.04,35423,17368,18055,466,0.5,2.0,1917.5,110.4,8.79254,51.991233,-687,0.961949598449183
6,4,33,8,8,Mörfelden-Walldorf,64546,44.13,35291,17887,17404,800,0.5,1.0,2867.1672793215403,109.8,8.567855,49.975563,483,1.027752240864169
5,1,54,16,16,Goch,47574,115.43,35270,17610,17660,306,0.5,3.0,2299.6821583030323,110.4,6.158868,51.674645,-50,0.9971687429218573
10,0,45,117,117,St. Ingbert,66386,49.95,35216,16974,18242,705,0.5,4.0,1957.0,109.2,7.115276,49.27897,-1268,0.9304900778423418
5,5,62,8,8,Datteln,45711,66.1,35191,17195,17996,532,0.5,3.0,2423.6821583030323,110.4,7.342615,51.653082,-801,0.9554901089130918
9,2,71,119,119,Deggendorf,94469,77.14,35172,17857,17315,456,0.5,4.0,3270.0,110.5,12.960122,48.842204,542,1.031302339012417
3,2,41,2,2,Barsinghausen,30890,102.81,35156,17349,17807,342,0.5,7.0,2462.298500580284,110.0,9.465004,52.301868,-458,0.9742797776155444
5,5,66,84,84,Steinfurt,48565,111.67,35102,17462,17640,314,0.5,2.0,2154.5,110.4,7.395195,52.125169,-178,0.9899092970521542
8,4,17,5002,2,Balingen,72336,90.32,34945,17081,17864,387,0.5,1.0,2548.402263880467,109.5,8.851349,48.275846,-783,0.9561688311688312
6,4,38,1,1,Dietzenbach,63128,21.68,34928,17352,17576,1611,0.5,2.0,3409.0,109.8,8.781779,50.008939,-224,0.9872553482020938
5,1,66,12,12,Kempen,47906,68.8,34841,16852,17989,506,0.5,3.0,2640.6821583030323,110.4,6.418755,51.364493,-1137,0.936794707877036
3,2,41,15,15,Seelze,30926,54.08,34742,17159,17583,642,0.5,5.0,2782.0,110.0,9.589384,52.396951,-424,0.9758857987829154
5,3,78,32,32,Wermelskirchen,42929,74.8,34739,16860,17879,464,0.5,3.0,2543.6821583030323,110.4,7.216722,51.140138,-1019,0.9430057609485989
10,0,44,115,115,Saarlouis,66740,43.3,34717,16729,17988,802,0.5,1.5,2327.0,109.2,6.75122,49.31506,-1259,0.930008894818768
1,0,56,50,50,Wedel,22880,33.81,34538,16674,17864,1022,0.5,1.0,3321.8139254001,109.4,9.705419,53.577353,-1190,0.9333855799373041
7,3,20,0,0,Zweibrücken,66482,70.64,34534,17075,17459,489,0.5,2.0,1807.0,109.8,7.363114,49.249189,-384,0.9780056131508105
6,4,31,20,20,Viernheim,68519,48.41,34534,16946,17588,713,0.5,2.0,2925.1597033712096,109.8,8.581954,49.537068,-642,0.9634978394359791
1,0,62,1,1,Ahrensburg,22926,35.29,34509,16398,18111,978,0.5,2.0,4378.0,109.4,10.239705,53.67575,-1713,0.9054165976478383
15,0,88,220,220,Merseburg,6217,53.75,34335,16743,17592,639,0.5,6.0,2462.4244458931207,110.7,11.992794,51.3571,-849,0.9517394270122783
5,1,54,12,12,Geldern,47608,96.97,34298,17098,17200,354,0.5,5.0,2232.5,110.4,6.323569,51.517533,-102,0.9940697674418605
5,1,62,20,20,Korschenbroich,41352,55.26,34187,16580,17607,619,0.5,2.0,2607.689734253363,110.4,6.515709,51.190965,-1027,0.9416709263361163
8,1,18,46,46,Kornwestheim,70806,14.65,34130,16834,17296,2330,0.5,2.0,4806.0,109.5,9.18586,48.86536,-462,0.9732886216466234
14,6,27,210,210,Radebeul,1445,26.14,34096,16427,17669,1304,0.5,4.0,2487.086243872349,110.3,13.677311,51.101437,-1242,0.9297073971362273
5,9,62,16,16,Hemer,58675,67.66,34024,16797,17227,503,0.5,2.0,1856.5,110.4,7.765233,51.385395,-430,0.9750391826783538
8,4,26,5003,21,Biberach an der Riß,88400,72.15,34008,16658,17350,471,0.5,5.0,3055.371960079152,109.5,9.79203,48.097465,-692,0.9601152737752161
3,3,60,25,25,Uelzen,29525,136.84,33934,16392,17542,248,0.5,5.0,2373.313652480945,110.0,10.560601,52.96495,-1150,0.9344430509634021
3,4,60,9,9,Vechta,49377,87.89,33769,16738,17031,384,0.5,4.0,2666.5,110.0,8.284838,52.727529,-293,0.9827960777405906
8,3,36,5004,69,Rheinfelden (Baden),79618,62.84,33581,16517,17064,534,0.5,2.0,3014.3946879301366,109.5,7.78365,47.561128,-547,0.9679442100328176
12,0,73,5051,532,Schwedt/Oder,16303,360.74,33495,16119,17376,93,0.5,6.0,1894.4244458931207,110.7,14.287861,53.055494,-1257,0.9276588397790055
6,4,40,2,2,Bad Nauheim,61231,32.54,33445,15838,17607,1028,0.5,4.0,3743.0,109.8,8.734962,50.363379,-1769,0.8995285965809053
5,3,58,24,24,Jülich,52428,90.39,33158,16635,16523,367,0.5,6.0,2497.6594304520477,110.4,6.357721,50.922697,112,1.0067784300671792
9,4,74,126,126,Forchheim,91301,44.44,32972,15967,17005,742,0.5,4.0,3475.5,110.5,11.0594,49.720292,-1038,0.9389591296677448
6,4,31,13,13,Lampertheim,68623,72.27,32870,16291,16579,455,0.5,2.0,2667.1597033712096,109.8,8.46255,49.595788,-288,0.9826286265757886
5,7,74,20,20,Delbrück,33129,157.28,32774,16670,16104,208,0.5,2.0,2512.5,110.4,8.562506,51.76505,566,1.0351465474416295
3,3,61,1,1,Achim,28832,68.06,32752,15944,16808,481,0.5,2.0,2466.33638033193,110.0,9.033031,53.01301,-864,0.94859590671109
8,1,15,5003,21,Herrenberg,71083,65.7,32649,15993,16656,497,0.5,2.0,3910.5,109.5,8.867369,48.595705,-663,0.9601945244956772
12,0,67,144,144,Fürstenwalde/Spree,15517,70.68,32646,16068,16578,462,0.5,3.0,2103.4471737441054,110.7,14.064713,52.35966,-510,0.9692363373145132
1,0,53,32,32,Geesthacht,21502,33.25,32336,15933,16403,973,0.5,3.0,3062.5,109.4,10.371785,53.433626,-470,0.9713467048710601
15,0,84,355,355,Naumburg (Saale),6618,129.9,32289,15595,16694,249,0.5,3.0,1989.4471737441054,110.7,11.809386,51.152814,-1099,0.9341679645381574
15,0,89,30,30,Bernburg (Saale),6406,113.55,32261,15624,16637,284,0.5,3.0,1219.0,110.7,11.737192,51.794389,-1013,0.9391116186812526
1,0,61,46,46,Itzehoe,25524,28.54,32258,15508,16750,1130,0.5,1.0,3482.8139254001,109.4,9.512178,53.926549,-1242,0.9258507462686567
3,4,59,19,19,Georgsmarienhütte,49124,55.49,32190,15774,16416,580,0.5,2.0,2720.33638033193,110.0,8.03415,52.206154,-642,0.9608918128654971
3,4,59,14,14,Bramsche,49565,183.39,32179,16519,15660,175,0.5,4.0,2154.0,110.0,7.97915,52.406729,859,1.05485312899106
3,2,56,22,22,Nienburg (Weser),31582,64.53,32126,15520,16606,498,0.5,3.0,2592.328804381599,110.0,9.211648,52.640859,-1086,0.9346019511020113
8,3,35,63,63,Radolfzell am Bodensee,78315,58.55,32043,15374,16669,547,0.5,2.0,3133.3946879301366,109.5,8.968663,47.739107,-1295,0.9223108764772932
15,0,85,370,370,Wernigerode,38855,170.2,32024,15296,16728,188,0.5,3.0,2103.0,110.7,10.7843,51.834471,-1432,0.9143950263032042
5,5,62,28,28,Oer-Erkenschwick,45739,38.66,31838,15496,16342,824,0.5,4.0,2757.674582352709,110.4,7.260829,51.639877,-846,0.948231550605801
5,1,54,8,8,Emmerich am Rhein,46446,80.4,31544,15777,15767,392,0.5,3.0,2034.5,110.4,6.242771,51.831485,10,1.0006342360626626
3,3,52,62,62,Geestland,27607,356.56,31507,15294,16213,88,0.5,7.0,2090.298500580284,110.0,8.594252,53.608072,-919,0.9433170912230926
12,0,68,320,320,Neuruppin,16816,305.2,31422,15367,16055,103,0.5,6.0,2667.0,110.7,12.806498,52.923365,-688,0.9571473061351604
14,6,25,240,240,Hoyerswerda / Wojerecy,2977,94.99,31356,15065,16291,330,0.5,2.0,1522.1013957730029,110.3,14.244028,51.438944,-1226,0.9247437235283286
16,0,77,1,1,Altenburg,4600,45.69,31315,14986,16329,685,0.5,1.0,1985.639002605487,110.9,12.437252,50.987195,-1343,0.9177536897544246
3,2,41,3,3,Burgdorf,31303,112.56,31287,15208,16079,278,0.5,4.0,2505.5,110.0,10.008766,52.446741,-871,0.9458299645500342
5,9,70,24,24,Kreuztal,57223,71.07,31197,15358,15839,439,0.5,2.0,2290.689734253363,110.4,7.988096,50.961831,-481,0.9696319212071469
5,1,70,32,32,Rheinberg,47495,75.24,31150,15210,15940,414,0.5,2.0,2405.5,110.4,6.602755,51.545023,-730,0.9542032622333751
5,9,54,12,12,Gevelsberg,58285,26.34,31097,15144,15953,1181,0.5,2.0,2880.689734253363,110.4,7.337464,51.324271,-809,0.9492885350717734
5,9,74,52,52,Werl,59457,76.35,31045,15831,15214,407,0.5,1.0,2223.6973102036936,110.4,7.914536,51.553012,617,1.0405547522019192
5,3,82,28,28,Lohmar,53797,65.62,30846,15070,15776,470,0.5,2.0,3133.5,110.4,7.209401,50.839775,-706,0.9552484787018256
3,3,58,24,24,Walsrode,29664,336.46,30819,15207,15612,92,0.5,2.0,1896.3363803319298,110.0,9.59609,52.861848,-405,0.9740584166026134
6,4,40,8,8,Friedberg (Hessen),61169,50.18,30818,15554,15264,614,0.5,6.0,3328.0,109.8,8.754091,50.33776,290,1.0189989517819706
6,4,39,15,15,Taunusstein,65232,67.02,30810,14956,15854,460,0.5,4.0,2814.1445514705556,109.8,8.159175,50.143382,-898,0.9433581430553803
8,3,36,91,91,Weil am Rhein,79576,19.46,30769,14959,15810,1581,0.5,3.0,3998.0,109.5,7.629579,47.594284,-851,0.9461733080328906
3,1,55,13,13,Einbeck,37574,231.92,30728,14966,15762,132,0.5,1.0,2133.3439562822605,110.0,9.86606,51.816626,-796,0.9494987945692172
3,3,56,7,7,Osterholz-Scharmbeck,27711,147.17,30659,14907,15752,208,0.5,2.0,2098.5,110.0,8.782826,53.230402,-845,0.9463560182833926
6,6,32,2,2,Bad Hersfeld,36251,73.87,30652,15032,15620,415,0.5,4.0,2309.1445514705556,109.8,9.706008,50.867805,-588,0.9623559539052496
5,9,54,8,8,Ennepetal,58256,57.77,30652,14918,15734,531,0.5,1.0,2248.5,110.4,7.367678,51.297193,-816,0.9481377907715774
5,1,58,8,8,Haan,42781,24.19,30542,14578,15964,1263,0.5,3.0,3419.0,110.4,7.010639,51.192305,-1386,0.9131796542219995
9,1,85,149,149,Neuburg a.d.Donau,86633,81.29,30467,15251,15216,375,0.5,1.0,2876.2856486840537,110.5,11.177543,48.736677,35,1.002300210304942
9,7,71,130,130,Friedberg,86316,81.25,30407,14846,15561,374,0.5,2.0,2592.278072733723,110.5,10.98469,48.353917,-715,0.9540517961570593
15,0,89,305,305,Schönebeck (Elbe),39218,86.08,30389,14657,15732,353,0.5,4.0,1392.0,110.7,11.738061,52.02049,-1075,0.9316679379608441
7,1,37,3,3,Andernach,56626,53.34,30277,14720,15557,568,0.5,2.0,2831.1597033712096,109.8,7.398566,50.439583,-837,0.946197853056502
8,2,16,15,15,Gaggenau,76571,65.01,30250,14898,15352,465,0.5,6.0,3111.0,109.5,8.317525,48.807364,-454,0.9704273058884836
8,2,15,5002,7,Bretten,75015,71.1,30073,14973,15100,423,0.5,2.0,2718.8946879301366,109.5,8.707641,49.036665,-127,0.9915894039735099
10,0,42,113,113,Merzig,66663,108.98,30051,14925,15126,276,0.5,1.0,2070.0,109.2,6.64256,49.44354,-201,0.9867116223720745
5,9,58,32,32,Meschede,59872,218.52,30025,14915,15110,137,0.5,5.0,1991.1670064023783,110.4,8.285176,51.346881,-195,0.9870946393117142
9,3,76,161,161,Schwandorf,92421,123.8,29990,14953,15037,242,0.5,2.0,2485.0,110.5,12.108976,49.327638,-84,0.9944137793442841
5,7,54,32,32,Rietberg,33397,110.31,29919,15083,14836,271,0.5,3.0,1860.1821583030323,110.4,8.427337,51.808062,247,1.016648692369911
1,0,58,135,135,Rendsburg,24768,23.75,29743,14994,14749,1252,0.5,2.0,3586.306349449769,109.4,9.663206,54.306495,245,1.0166112956810631
5,9,78,40,40,Werne,59368,76.14,29680,14303,15377,390,0.5,2.0,2390.5,110.4,7.635119,51.663179,-1074,0.9301554269363335
5,5,70,28,28,Oelde,59302,102.77,29644,14792,14852,288,0.5,1.0,2268.1973102036936,110.4,8.146074,51.827467,-60,0.9959601400484783
5,5,62,36,36,Waltrop,45731,47.09,29644,14283,15361,630,0.5,2.0,2398.0,110.4,7.400687,51.622128,-1078,0.929822277195495
13,0,72,43,43,Güstrow,18273,71.09,29556,14295,15261,416,0.5,2.0,1884.2197651355164,111.0,12.175691,53.794458,-966,0.9367013957145666
9,1,81,130,130,Landsberg am Lech,86899,57.9,29551,14710,14841,510,0.5,1.0,5176.5,110.5,10.877828,48.049514,-131,0.9911731015430227
9,1,84,149,149,Unterschleißheim,85716,14.93,29523,14898,14625,1977,0.5,2.0,4326.278072733723,110.5,11.577905,48.277306,273,1.0186666666666666
3,1,55,11,11,Northeim,37154,145.85,29440,14340,15100,202,0.5,6.0,1535.0,110.0,10.000406,51.705681,-760,0.9496688741721855
5,1,66,28,28,Tönisvorst,47918,44.34,29319,14391,14928,661,0.5,3.0,2778.1821583030323,110.4,6.492628,51.320838,-537,0.9640273311897106
8,1,18,5008,73,Vaihingen an der Enz,71665,73.4,29305,14556,14749,399,0.5,3.0,3423.5,109.5,8.960417,48.933224,-193,0.986914367075734
6,4,38,8,8,Mühlheim am Main,63165,20.67,29252,14587,14665,1415,0.5,3.0,3557.652127420879,109.8,8.835525,50.122715,-78,0.9946812137742925
8,1,19,5006,85,Winnenden,71364,28.05,29245,14400,14845,1043,0.5,2.0,4327.0,109.5,9.396202,48.877185,-445,0.9700235769619401
16,0,73,77,77,Saalfeld/Saale,7318,145.56,29224,14134,15090,201,0.5,1.0,1513.139002605487,110.9,11.361357,50.647648,-956,0.9366467859509608
8,2,16,5002,7,Bühl,77815,73.18,29133,14293,14840,398,0.5,6.0,3130.5,109.5,8.136444,48.696265,-547,0.9631401617250673
3,2,41,17,17,Springe,31832,160.13,29113,14165,14948,182,0.5,1.0,2041.8439562822605,110.0,9.554961,52.208899,-783,0.9476184104896976
6,4,36,8,8,Kelkheim (Taunus),65779,30.73,29112,14226,14886,947,0.5,3.0,4446.5,109.8,8.452115,50.133925,-660,0.9556630390971382
14,6,27,230,230,Riesa,1589,58.91,29076,13969,15107,494,0.5,6.0,1866.0710919716876,110.3,13.304633,51.30251,-1138,0.9246706824650824
14,6,27,140,140,Meißen,1662,30.92,29011,13946,15065,938,0.5,3.0,1754.0,110.3,13.468635,51.159993,-1119,0.9257218718884832
5,3,78,28,28,Rösrath,51503,38.8,28889,14049,14840,745,0.5,2.0,2851.189734253363,110.4,7.181947,50.895438,-791,0.9466981132075472
8,3,16,5003,11,Emmendingen,79312,33.78,28856,14004,14852,854,0.5,3.0,3896.5,109.5,7.847625,48.122053,-848,0.9429033126851603
7,1,34,45,45,Idar-Oberstein,55743,91.58,28851,14090,14761,315,0.5,6.0,2753.1293995698943,109.8,7.312126,49.713356,-671,0.9545423751778335
6,4,38,12,12,Rödermark,63322,29.99,28834,14071,14763,961,0.5,2.0,3467.0,109.8,8.827442,49.978893,-692,0.9531260583892163
5,9,54,24,24,Schwelm,58332,20.5,28723,13781,14942,1401,0.5,2.0,3100.689734253363,110.4,7.29187,51.284,-1161,0.9222995582920627
5,7,62,20,20,Höxter,37671,158.16,28709,14147,14562,182,0.5,3.0,1513.0,110.4,9.381623,51.775666,-415,0.9715011674220574
8,1,17,5004,24,Geislingen an der Steige,73312,75.83,28655,14392,14263,378,0.5,2.0,2712.3946879301366,109.5,9.835836,48.623045,129,1.0090443805650986
5,3,66,28,28,Mechernich,53894,136.48,28567,14180,14387,209,0.5,1.0,2184.6973102036936,110.4,6.653673,50.588604,-207,0.9856120108431222
1,0,62,60,60,Reinbek,21465,31.26,28536,14017,14519,913,0.5,2.0,4112.0,109.4,10.2519,53.491012,-502,0.9654246160203871
6,4,36,5,5,Hattersheim am Main,65795,15.8,28528,14181,14347,1806,0.5,1.0,3823.6672793215403,109.8,8.485929,50.07225,-166,0.9884296368578797
3,3,61,12,12,Verden (Aller),27283,71.7,28526,13882,14644,398,0.5,4.0,2282.0,110.0,9.231105,52.923403,-762,0.9479650368751708
12,0,72,240,240,Ludwigsfelde,14974,109.98,28424,13975,14449,258,0.5,2.0,1929.454749694436,110.7,13.262008,52.30004,-474,0.9671949615890373
6,6,33,3,3,Baunatal,34225,38.27,28339,13618,14721,741,0.5,5.0,2412.5,109.8,9.415659,51.254184,-1103,0.9250730249303716
5,3,70,12,12,Geilenkirchen,52511,83.16,28252,14092,14160,340,0.5,2.0,2382.689734253363,110.4,6.119722,50.964538,-68,0.9951977401129943
5,1,54,32,32,Kevelaer,47623,100.64,28232,13890,14342,281,0.5,3.0,2241.5,110.4,6.24718,51.58178,-452,0.968484172360898
9,7,72,163,163,Königsbrunn,86343,18.4,28231,13896,14335,1534,0.5,1.0,3607.2856486840537,110.5,10.889586,48.267499,-439,0.9693756539937216
14,7,29,160,160,Grimma,4668,218.23,28205,13842,14363,129,0.5,3.0,1447.0,110.3,12.72714,51.235476,-521,0.9637262410359952
16,0,70,4,4,Arnstadt,99310,104.99,28124,14012,14112,268,0.5,2.0,2527.6314266551562,110.9,10.946529,50.8333,-100,0.9929138321995464
5,3,70,40,40,Wegberg,41844,84.34,28074,13748,14326,333,0.5,3.0,2103.0,110.4,6.276829,51.140129,-578,0.959653776350691
5,3,78,16,16,Leichlingen (Rheinland),42799,37.26,28048,13387,14661,753,0.5,5.0,2922.1670064023783,110.4,7.014244,51.106014,-1274,0.9131027897142078
15,0,84,590,590,Zeitz,6712,87.16,27976,13548,14428,321,0.5,2.0,1046.0,110.7,12.134473,51.050371,-880,0.9390074854449681
5,1,70,28,28,Neukirchen-Vluyn,47506,43.5,27956,13495,14461,643,0.5,5.0,2898.1670064023783,110.4,6.573385,51.447044,-966,0.933199640412143
9,1,79,142,142,Olching,82140,29.92,27927,13596,14331,933,0.5,3.0,6493.5,110.5,11.331193,48.209243,-735,0.9487125811178564
6,4,32,8,8,Griesheim,64347,21.55,27837,13843,13994,1292,0.5,3.0,3942.0,109.8,8.552637,49.859176,-151,0.9892096612834071
3,4,60,6,6,Lohne (Oldenburg),49393,91.11,27814,13984,13830,305,0.5,3.0,2468.828804381599,110.0,8.238487,52.66558,154,1.0111352133044107
5,9,58,44,44,Sundern (Sauerland),59846,193.27,27741,13895,13846,144,0.5,2.0,1875.189734253363,110.4,8.005553,51.330125,49,1.0035389282103135
12,0,69,616,616,Teltow,14513,21.6,27697,13595,14102,1282,0.5,1.0,3009.4623256447667,110.7,13.268496,52.400559,-507,0.9640476528152035
5,3,34,8,8,Baesweiler,52499,27.84,27620,13366,14254,992,0.5,2.0,2211.5,110.4,6.181166,50.906664,-888,0.9377016977690473
5,9,54,32,32,Wetter (Ruhr),58300,31.55,27550,13577,13973,873,0.5,1.0,2559.6973102036936,110.4,7.390737,51.383741,-396,0.9716596292850498
5,7,54,36,36,Schloß Holte-Stukenbrock,33758,67.52,27467,13567,13900,407,0.5,4.0,2806.5,110.4,8.656299,51.912069,-333,0.9760431654676259
8,4,36,5007,81,Wangen im Allgäu,88239,101.35,27411,13343,14068,270,0.5,3.0,2869.387111979806,109.5,9.832354,47.685855,-725,0.9484646005117998
5,3,78,24,24,Overath,51491,68.88,27405,13433,13972,398,0.5,2.0,2782.0,110.4,7.282487,50.933092,-539,0.9614228456913828
6,4,40,5,5,Butzbach,35510,106.6,27402,13834,13568,257,0.5,2.0,2149.6597033712096,109.8,8.672123,50.433537,266,1.0196049528301887
12,0,64,472,472,Strausberg,15344,67.95,27344,13105,14239,402,0.5,2.0,2192.454749694436,110.7,13.881977,52.579644,-1134,0.9203595758129082
8,4,25,5005,33,Ehingen (Donau),89584,178.33,27276,13813,13463,153,0.5,2.0,2818.0,109.5,9.725211,48.283666,350,1.0259971774493055
5,1,70,12,12,Hamminkeln,46499,164.53,27248,13559,13689,166,0.5,3.0,2240.6821583030323,110.4,6.589158,51.730832,-130,0.9905033238366572
8,2,26,41,41,Leimen,69181,20.64,27142,13410,13732,1315,0.5,1.0,3459.0,109.5,8.688782,49.349054,-322,0.9765511214681037
12,0,65,144,144,Hohen Neuendorf,16540,48.56,27139,13235,13904,559,0.5,3.0,2214.9471737441054,110.7,13.279528,52.671291,-669,0.9518843498273878
5,3,82,48,48,Rheinbach,53359,69.72,27102,13617,13485,389,0.5,2.0,3262.5,110.4,6.947218,50.626425,132,1.0097886540600667
8,1,19,91,91,Weinstadt,71384,31.71,27088,13326,13762,854,0.5,3.0,3350.387111979806,109.5,9.385556,48.803451,-436,0.9683185583490772
8,2,26,5010,98,Wiesloch,69168,30.24,27049,13460,13589,894,0.5,2.0,3216.8946879301366,109.5,8.701276,49.293493,-129,0.9905070277430275
12,0,69,656,656,Werder (Havel),14542,117.12,27039,13267,13772,231,0.5,2.0,3711.0,110.7,12.934139,52.376456,-505,0.9633313970374673
6,4,31,11,11,Heppenheim (Bergstraße),64646,52.12,26946,13393,13553,517,0.5,4.0,2783.1445514705556,109.8,8.644017,49.641185,-160,0.9881944956836125
9,1,86,143,143,Pfaffenhofen a.d.Ilm,85276,92.63,26943,13381,13562,291,0.5,2.0,2843.778072733723,110.5,11.503851,48.529783,-181,0.9866538858575431
12,0,65,136,136,Hennigsdorf,16761,31.48,26728,13100,13628,849,0.5,4.0,2514.439597793782,110.7,13.209009,52.639059,-528,0.9612562371587907
5,1,58,12,12,Heiligenhaus,42579,27.52,26681,12984,13697,970,0.5,4.0,2829.5,110.4,6.966531,51.326038,-713,0.9479448054318463
7,1,31,7,7,Bad Neuenahr-Ahrweiler,53474,63.38,26669,12807,13862,421,0.5,5.0,2777.136975520225,109.8,7.120457,50.545218,-1055,0.923892656182369
15,0,89,15,15,Aschersleben,6449,156.36,26604,12749,13855,170,0.5,1.0,1112.5,110.7,11.455041,51.756034,-1106,0.9201732226632985
8,1,18,81,81,Remseck am Neckar,71686,22.82,26549,13213,13336,1163,0.5,2.0,3553.8946879301366,109.5,9.279445,48.87067,-123,0.9907768446310737
8,1,25,5008,65,Neckarsulm,74172,24.94,26495,13131,13364,1062,0.5,1.0,3640.5,109.5,9.223944,49.190147,-233,0.9825651002693804
8,3,17,5001,1,Achern,77855,65.24,26471,13158,13313,406,0.5,3.0,2755.387111979806,109.5,8.074429,48.628851,-155,0.9883572447983174
9,5,74,138,138,Lauf a.d.Pegnitz,91207,59.86,26420,12905,13515,441,0.5,4.0,2920.762920833069,110.5,11.278019,49.511562,-610,0.9548649648538661
6,4,33,6,6,Groß-Gerau,64521,54.47,26418,13154,13264,485,0.5,2.0,3308.0,109.8,8.482423,49.92162,-110,0.9917068757539204
8,2,36,5004,40,Mühlacker,75417,54.32,26394,13112,13282,486,0.5,3.0,2996.387111979806,109.5,8.8419,48.945605,-170,0.9872007227827134
6,4,32,23,23,Weiterstadt,64331,34.4,26322,13339,12983,765,0.5,3.0,3667.0,109.8,8.588464,49.905719,356,1.0274204729261343
7,3,39,5,5,Bingen am Rhein,55411,37.68,26309,12983,13326,698,0.5,2.0,2849.6597033712096,109.8,7.895132,49.96663,-343,0.9742608434639052
3,4,61,7,7,Nordenham,26954,87.77,26308,13060,13248,300,0.5,3.0,1502.0,110.0,8.484084,53.484863,-188,0.9858091787439613
9,5,73,134,134,Zirndorf,90513,28.79,26234,12806,13428,911,0.5,3.0,3288.2704967833924,110.5,10.956456,49.441541,-622,0.9536788799523384
5,9,78,32,32,Selm,59379,60.41,26163,12634,13529,433,0.5,2.0,2397.189734253363,110.4,7.468573,51.70035,-895,0.9338458126986473
5,3,82,8,8,Bad Honnef,53604,48.14,26061,12476,13585,541,0.5,1.0,3370.0,110.4,7.229126,50.643591,-1109,0.9183658446816342
5,7,70,20,20,Lübbecke,32312,65.04,26027,12707,13320,400,0.5,2.0,2092.689734253363,110.4,8.617351,52.303439,-613,0.953978978978979
5,7,54,16,16,Harsewinkel,33428,100.59,25999,13097,12902,258,0.5,1.0,2310.0,110.4,8.227621,51.963062,195,1.0151139358239032
9,7,76,116,116,Lindau (Bodensee),88131,33.06,25846,12490,13356,782,0.5,1.0,2991.7856486840537,110.5,9.661948,47.571583,-866,0.9351602276130578
1,0,59,75,75,Schleswig,24837,24.3,25832,12509,13323,1063,0.5,3.0,2681.5,109.4,9.566657,54.514941,-814,0.9389026495534039
9,4,77,128,128,Kulmbach,95326,92.77,25818,12442,13376,278,0.5,2.0,2779.278072733723,110.5,11.455614,50.10807,-934,0.9301734449760766
3,1,54,28,28,Helmstedt,38350,66.74,25779,12541,13238,386,0.5,1.0,2493.8439562822605,110.0,11.010462,52.227571,-697,0.9473485420758423
8,2,37,5003,40,Horb am Neckar,72160,119.76,25752,13063,12689,215,0.5,2.0,2259.5,109.5,8.692721,48.445165,374,1.0294743478603514
3,2,57,31,31,Rinteln,31737,109.02,25721,12598,13123,236,0.5,2.0,2276.33638033193,110.0,9.079841,52.186989,-525,0.959993903832965
8,1,36,5003,19,Ellwangen (Jagst),73479,127.38,25678,13017,12661,202,0.5,2.0,2641.0,109.5,10.131979,48.962988,356,1.0281178421925599
6,4,34,2,2,Friedrichsdorf,61381,30.13,25662,12536,13126,852,0.5,7.0,3229.6218236195637,109.8,8.641683,50.256846,-590,0.9550510437300015
9,1,73,126,126,Geretsried,82538,24.6,25623,12680,12943,1042,0.5,2.0,5620.0,110.5,11.482265,47.856254,-263,0.979680135980839
10,0,46,117,117,St. Wendel,66606,113.53,25583,12531,13052,225,0.5,1.0,2968.137248439387,109.2,7.173032,49.468359,-521,0.9600827459393196
6,4,39,8,8,Idstein,65510,79.76,25554,12196,13358,320,0.5,3.0,3267.5,109.8,8.233802,50.267277,-1162,0.9130109297799072
5,7,54,44,44,Verl,33415,71.37,25522,12792,12730,358,0.5,3.0,1985.1821583030323,110.4,8.508286,51.882118,62,1.0048703849175176
8,3,25,5003,49,Rottweil,78628,71.76,25513,12563,12950,356,0.5,5.0,2896.871960079152,109.5,8.627337,48.167866,-387,0.9701158301158301
5,9,58,12,12,Brilon,59929,229.16,25511,12623,12888,111,0.5,5.0,1495.5,110.4,8.568121,51.395499,-265,0.9794382371198014
15,0,87,370,370,Sangerhausen,6526,207.71,25441,12337,13104,122,0.5,2.0,1787.454749694436,110.7,11.298597,51.473662,-767,0.941468253968254
8,1,26,5005,66,Öhringen,74613,67.79,25388,12525,12863,375,0.5,3.0,3070.0,109.5,9.501119,49.200104,-338,0.9737230817072222
9,5,76,143,143,Roth,91154,96.33,25367,12263,13104,263,0.5,2.0,2672.778072733723,110.5,11.090664,49.244523,-841,0.9358211233211233
5,9,66,20,20,Lennestadt,57368,135.59,25352,12689,12663,187,0.5,6.0,1530.0,110.4,8.073677,51.103245,26,1.0020532259338228
5,3,74,48,48,Wiehl,51674,53.26,25314,12260,13054,475,0.5,1.0,2550.1973102036936,110.4,7.547029,50.949871,-794,0.9391757315765282
5,7,74,36,36,Salzkotten,33154,109.8,25311,12532,12779,231,0.5,2.0,1937.689734253363,110.4,8.604954,51.671701,-247,0.9806714140386572
6,4,38,10,10,Obertshausen,63179,13.62,25307,12486,12821,1858,0.5,1.0,3628.5,109.8,8.848662,50.072108,-335,0.9738709929022697
5,5,58,24,24,Lüdinghausen,59348,140.54,25259,12527,12732,180,0.5,5.0,2259.1670064023783,110.4,7.443711,51.770372,-205,0.9838988375746152
8,4,36,5005,82,Weingarten,88250,12.16,25257,12158,13099,2077,0.5,4.0,3993.0,109.5,9.640669,47.807399,-941,0.928162455149248
14,7,30,70,70,Delitzsch,4509,85.92,25244,12416,12828,294,0.5,2.0,1380.1013957730029,110.3,12.333551,51.52333,-412,0.9678827564702214
6,4,32,18,18,Pfungstadt,64319,42.54,25231,12470,12761,593,0.5,1.0,3404.0,109.8,8.597771,49.801774,-291,0.9771961445027819
5,7,70,28,28,Petershagen,32469,211.94,25222,12581,12641,119,0.5,5.0,1850.6670064023783,110.4,8.969816,52.378264,-60,0.9952535400680326
8,2,15,109,109,Stutensee,76297,45.68,25204,12478,12726,552,0.5,3.0,3616.0,109.5,8.470789,49.063748,-248,0.9805123369479806
3,4,52,19,19,Norden,26506,106.33,25179,12222,12957,237,0.5,1.0,2062.3439562822605,110.0,7.202462,53.59498,-735,0.9432739059967585
5,7,70,8,8,Espelkamp,32339,84.21,25174,12223,12951,299,0.5,1.0,1668.5,110.4,8.632644,52.377427,-728,0.943788124469153
8,1,18,11,11,Ditzingen,71254,30.38,25145,12499,12646,828,0.5,3.0,3267.387111979806,109.5,9.068779,48.827632,-147,0.9883757709947809
15,0,82,180,180,Köthen (Anhalt),6366,77.44,25116,12190,12926,324,0.5,2.0,1182.5,110.7,11.973406,51.751224,-736,0.9430604982206405
5,9,66,24,24,Olpe,57462,85.88,25015,12387,12628,291,0.5,6.0,2305.1594304520477,110.4,7.843584,51.02756,-241,0.9809154260373772
5,9,62,52,52,Plettenberg,58840,96.75,24954,12392,12562,258,0.5,6.0,1484.0,110.4,7.874142,51.212418,-170,0.986467123069575
1,0,62,4,4,Bad Oldesloe,23843,52.59,24935,12195,12740,474,0.5,2.0,2884.806349449769,109.4,10.373196,53.810046,-545,0.957221350078493
5,9,58,40,40,Schmallenberg,57392,303.1,24878,12567,12311,82,0.5,3.0,1599.5,110.4,8.285496,51.153811,256,1.020794411501909
5,3,82,32,32,Meckenheim,53340,34.84,24877,12059,12818,714,0.5,3.0,2922.6821583030323,110.4,7.022259,50.622043,-759,0.9407863941332502
5,9,54,28,28,Sprockhövel,45549,47.94,24838,12002,12836,518,0.5,2.0,2827.5,110.4,7.244016,51.361402,-834,0.935026488002493
3,2,51,41,41,Syke,28857,128.11,24810,12189,12621,194,0.5,2.0,2156.83638033193,110.0,8.816336,52.914548,-432,0.9657713334917993
14,6,26,610,610,Zittau,2763,66.75,24794,12224,12570,371,0.5,4.0,1832.0862438723489,110.3,14.764425,50.917489,-346,0.9724741447891806
16,0,73,76,76,Rudolstadt,7407,135.18,24749,12014,12735,183,0.5,1.0,1644.0,110.9,11.343567,50.721635,-721,0.9433843737730664
16,0,66,5050,42,Meiningen,98617,105.64,24745,12151,12594,234,0.5,2.0,2412.1314266551562,110.9,10.236161,50.562031,-443,0.9648245196125139
5,9,74,44,44,Warstein,59581,158.05,24647,12287,12360,156,0.5,2.0,1564.0,110.4,8.353834,51.442787,-73,0.9940938511326861
8,3,37,5007,126,Waldshut-Tiengen,79761,77.96,24605,12088,12517,316,0.5,4.0,2946.8795360294826,109.5,8.271113,47.632439,-429,0.9657266118079412
12,0,63,252,252,Rathenow,14712,113.1,24597,11927,12670,217,0.5,2.0,1778.5,110.7,12.332831,52.60768,-743,0.9413575374901342
3,2,41,14,14,Ronnenberg,30952,37.82,24570,12151,12419,650,0.5,3.0,2602.328804381599,110.0,9.653235,52.319008,-268,0.9784201626539979
8,1,28,5001,7,Bad Mergentheim,97980,129.96,24564,12052,12512,189,0.5,7.0,3092.3568081784906,109.5,9.773085,49.490973,-460,0.9632352941176471
14,7,29,260,260,Markkleeberg,4416,31.47,24523,11686,12837,779,0.5,5.0,3455.0,110.3,12.374495,51.280005,-1151,0.9103373062241957
3,4,54,18,18,Haren (Ems),49733,208.79,24498,12348,12150,117,0.5,2.0,2137.33638033193,110.0,7.241754,52.790479,198,1.0162962962962963
9,1,83,148,148,Waldkraiburg,84478,21.56,24488,12149,12339,1136,0.5,1.0,3262.5,110.5,12.400382,48.208301,-190,0.9846016695032013
5,9,66,4,4,Attendorn,57439,97.92,24448,12232,12216,250,0.5,4.0,2145.174582352709,110.4,7.905217,51.125217,16,1.0013097576948264
9,5,72,132,132,Herzogenaurach,91074,47.62,24404,12099,12305,512,0.5,2.0,2863.778072733723,110.5,10.883873,49.568566,-206,0.9832588378707843
3,4,55,26,26,Varel,26316,113.75,24397,11891,12506,214,0.5,3.0,2020.5,110.0,8.135174,53.394916,-615,0.9508236046697586
5,3,62,4,4,Bedburg,50181,80.42,24302,12062,12240,302,0.5,2.0,2279.689734253363,110.4,6.575238,50.994862,-178,0.9854575163398693
8,2,37,5002,28,Freudenstadt,72250,87.54,24301,11887,12414,278,0.5,3.0,2314.5,109.5,8.411368,48.463876,-527,0.9575479297567263
15,0,89,310,310,Staßfurt,39418,146.67,24293,11803,12490,166,0.5,4.0,2293.939597793782,110.7,11.581513,51.85714,-687,0.944995996797438
8,2,35,5006,85,Calw,75365,59.88,24219,12197,12022,404,0.5,3.0,2923.387111979806,109.5,8.741194,48.713372,175,1.0145566461487274
5,3,70,28,28,Übach-Palenberg,52531,26.09,24215,12166,12049,928,0.5,2.0,1977.0,110.4,6.118933,50.919252,117,1.0097103494065898
6,4,33,11,11,Riedstadt,64560,73.73,24209,12148,12061,328,0.5,3.0,2559.652127420879,109.8,8.497909,49.835419,87,1.0072133322278418
3,2,41,16,16,Sehnde,31319,103.58,24157,12146,12011,233,0.5,2.0,2554.5,110.0,9.967173,52.310452,135,1.0112396969444675
12,0,67,120,120,Eisenhüttenstadt,15890,63.48,24125,11677,12448,380,0.5,4.0,2095.939597793782,110.7,14.631279,52.145788,-771,0.9380623393316195
5,1,62,12,12,Jüchen,41363,72.04,23940,11772,12168,332,0.5,4.0,2439.5,110.4,6.503837,51.100795,-396,0.9674556213017751
3,4,51,7,7,Westerstede,26655,179.56,23854,11590,12264,133,0.5,3.0,1992.3288043815992,110.0,7.923336,53.25741,-674,0.9450424005218526
14,5,24,5114,180,Limbach-Oberfrohna,9212,50.21,23833,11689,12144,475,0.5,5.0,1402.0,110.3,12.767069,50.858593,-455,0.9625329380764164
14,5,22,80,80,Döbeln,4720,91.75,23763,11722,12041,259,0.5,4.0,1477.5862438723489,110.3,13.121007,51.121669,-319,0.9735071837887219
9,1,88,139,139,Starnberg,82319,61.85,23741,11139,12602,384,0.5,4.0,3084.262920833069,110.5,11.33837,47.996607,-1463,0.8839073162990002
1,0,54,56,56,Husum,25813,25.8,23735,11366,12369,920,0.5,2.0,2714.0,109.4,9.057178,54.477143,-1003,0.9189101786724877
6,6,35,15,15,Korbach,34497,124.11,23706,11581,12125,191,0.5,2.0,1995.1597033712096,109.8,8.873194,51.27186,-544,0.9551340206185567
6,4,35,10,10,Gelnhausen,63571,45.15,23679,11501,12178,524,0.5,3.0,2820.0,109.8,9.191488,50.203103,-677,0.9444079487600591
15,0,81,455,455,Salzwedel,29410,304.57,23543,11631,11912,77,0.5,4.0,1988.939597793782,110.7,11.153862,52.852801,-281,0.9764103425117528
1,0,60,44,44,Kaltenkirchen,24568,23.11,23538,11431,12107,1019,0.5,3.0,3086.5,109.4,9.959311,53.838257,-676,0.9441645329148427
3,1,59,17,17,Hann. Münden,34346,121.17,23530,11589,11941,194,0.5,2.0,2300.83638033193,110.0,9.654832,51.415826,-352,0.970521731848254
16,0,72,18,18,Sonneberg,96515,84.69,23507,11420,12087,278,0.5,5.0,2712.6086988041716,110.9,11.175725,50.357569,-667,0.9448167452635062
8,2,25,5005,58,Mosbach,74821,62.16,23484,11742,11742,378,0.5,4.0,2436.5,109.5,9.146596,49.352037,0,1.0
6,5,32,6,6,Dillenburg,35683,83.76,23480,11631,11849,280,0.5,2.0,2120.6597033712096,109.8,8.287324,50.739424,-218,0.9816018229386446
12,0,66,304,304,Senftenberg/Zły Komorow,1968,127.56,23405,11265,12140,183,0.5,2.0,1729.954749694436,110.7,14.004312,51.518751,-875,0.9279242174629324
5,9,70,32,32,Netphen,57250,137.39,23363,11554,11809,170,0.5,5.0,2030.0,110.4,8.098414,50.915322,-255,0.9784063002794479
8,4,36,5004,55,Leutkirch im Allgäu,88299,174.97,23345,11737,11608,133,0.5,4.0,2687.3795360294826,109.5,10.024379,47.825064,129,1.0111130254996554
5,7,62,36,36,Warburg,34414,168.84,23322,11432,11890,138,0.5,3.0,1758.5,110.4,9.145955,51.488934,-458,0.9614802354920101
15,0,85,235,235,Quedlinburg,6484,120.53,23313,11024,12289,193,0.5,5.0,1998.4320218434514,110.7,11.137136,51.790437,-1265,0.8970624135405647
9,7,72,147,147,Gersthofen,86368,34.01,23274,11561,11713,684,0.5,3.0,4450.5,110.5,10.87901,48.424752,-152,0.9870229659352856
8,1,28,131,131,Wertheim,97877,138.59,23196,11538,11658,167,0.5,2.0,2976.3946879301366,109.5,9.516823,49.759581,-120,0.9897066392177046
6,4,40,12,12,Karben,61184,43.94,23172,11453,11719,527,0.5,3.0,3781.5,109.8,8.773103,50.230102,-266,0.9773018175612254
6,4,36,1,1,Bad Soden am Taunus,65812,12.5,23162,11138,12024,1853,0.5,2.0,3949.6597033712096,109.8,8.5018,50.143796,-886,0.9263140385894877
5,5,54,68,68,Vreden,48691,135.83,23161,11820,11341,171,0.5,4.0,2061.674582352709,110.4,6.824021,52.036087,479,1.0422361343796844
8,4,35,5007,59,Überlingen,88662,58.64,23098,10809,12289,394,0.5,1.0,5249.5,109.5,9.159266,47.768547,-1480,0.8795670925217675
16,0,71,1,1,Apolda,99510,46.26,23072,11281,11791,499,0.5,2.0,2804.6314266551562,110.9,11.517678,51.025292,-510,0.9567466711898905
9,1,90,157,157,Weilheim i.OB,82362,55.5,23056,11109,11947,415,0.5,5.0,3155.2553448827384,110.5,11.144997,47.839999,-838,0.9298568678329288
9,6,72,114,114,Bad Kissingen,97688,69.92,23037,10704,12333,329,0.5,2.0,2775.278072733723,110.5,10.077888,50.200795,-1629,0.8679153490634882
16,0,63,5051,3,Bad Salzungen,36433,152.02,23013,11268,11745,151,0.5,3.0,1555.0,110.9,10.231992,50.811679,-477,0.9593869731800766
8,2,35,5007,46,Nagold,72202,63.1,22985,11420,11565,364,0.5,1.0,2756.902263880467,109.5,8.723706,48.550906,-145,0.9874621703415478
5,5,66,40,40,Lengerich,49525,90.79,22980,11440,11540,253,0.5,1.0,2109.5,110.4,7.85266,52.189765,-100,0.9913344887348353
9,6,75,141,141,Kitzingen,97318,46.99,22945,11287,11658,488,0.5,1.0,2853.7856486840537,110.5,10.159239,49.736047,-371,0.9681763595814034
3,4,53,7,7,Friesoythe,26169,247.5,22945,11474,11471,93,0.5,1.0,1824.5,110.0,7.859448,53.020613,3,1.0002615290733152
9,7,75,152,152,Senden,89250,25.21,22896,11186,11710,908,0.5,2.0,3162.278072733723,110.5,10.04419,48.323834,-524,0.9552519214346712
9,7,72,184,184,Neusäß,86356,25.22,22872,10916,11956,907,0.5,1.0,4637.5,110.5,10.831597,48.395449,-1040,0.9130143860823018
8,4,26,5005,70,Laupheim,88471,61.79,22863,11459,11404,370,0.5,3.0,2884.387111979806,109.5,9.883733,48.230018,55,1.0048228691687127
5,9,54,20,20,Herdecke,58313,22.39,22758,10789,11969,1016,0.5,6.0,2657.0,110.4,7.430129,51.3994,-1180,0.9014119809507896
15,0,86,15,15,Burg,39288,164.26,22689,11405,11284,138,0.5,4.0,2042.939597793782,110.7,11.854736,52.269775,121,1.0107231478199221
3,3,57,39,39,Rotenburg (Wümme),27356,99.06,22656,11081,11575,229,0.5,2.0,2192.83638033193,110.0,9.403666,53.110417,-494,0.9573218142548596
3,2,57,35,35,Stadthagen,31655,60.27,22643,11001,11642,376,0.5,3.0,1586.0,110.0,9.205815,52.323705,-641,0.9449407318330184
15,0,87,130,130,Eisleben,6295,143.94,22639,11038,11601,157,0.5,2.0,1733.454749694436,110.7,11.54734,51.53115,-563,0.9514697008878545
6,4,40,4,4,Büdingen,63654,122.88,22622,11313,11309,184,0.5,3.0,2289.0,109.8,9.114105,50.292506,4,1.0003537005924485
8,4,15,5002,50,Metzingen,72555,34.55,22528,11098,11430,652,0.5,1.0,2825.402263880467,109.5,9.283998,48.536849,-332,0.9709536307961505
8,3,26,5001,12,Donaueschingen,78166,104.69,22431,11141,11290,214,0.5,1.0,2652.5,109.5,8.497777,47.951414,-149,0.9868024800708591
8,1,25,5002,6,Bad Rappenau,74906,73.56,22356,11105,11251,304,0.5,3.0,2774.387111979806,109.5,9.103117,49.240303,-146,0.9870233756999378
5,7,54,48,48,Versmold,33775,85.57,22274,11181,11093,260,0.5,4.0,2098.0,110.4,8.155495,52.040049,88,1.0079329306770035
8,1,25,5004,26,Eppingen,75031,88.58,22226,11131,11095,251,0.5,2.0,2673.8946879301366,109.5,8.909012,49.137701,36,1.003244704821992
5,3,74,36,36,Radevormwald,42477,53.86,22222,10767,11455,413,0.5,2.0,2435.689734253363,110.4,7.355144,51.203463,-688,0.9399388913138368
1,0,56,41,41,Quickborn,25451,43.16,22165,10731,11434,514,0.5,2.0,3616.5,109.4,9.898034,53.728836,-703,0.9385167045653314
8,3,16,5006,56,Waldkirch,79183,48.47,22127,10725,11402,457,0.5,2.0,2832.3946879301366,109.5,7.961225,48.093941,-677,0.9406244518505525
1,0,51,44,44,Heide,25746,31.97,22114,10673,11441,692,0.5,1.0,2168.0,109.4,9.091156,54.193962,-768,0.9328730006118346
6,4,36,3,3,Eschborn,65760,12.13,22070,10986,11084,1819,0.5,5.0,4022.136975520225,109.8,8.569823,50.143505,-98,0.9911584265608083
8,2,26,84,84,Schwetzingen,68723,21.5,22062,10810,11252,1026,0.5,2.0,3800.0,109.5,8.585149,49.368098,-442,0.9607180945609669
15,0,81,135,135,Gardelegen,39638,633.72,22054,10971,11083,35,0.5,3.0,1575.9471737441054,110.7,11.394214,52.524469,-112,0.9898944329152757
5,3,62,16,16,Elsdorf,50189,66.17,22021,10812,11209,333,0.5,5.0,2307.5,110.4,6.567973,50.936059,-397,0.9645820322954769
5,7,54,12,12,Halle (Westf.),33790,69.7,21970,10840,11130,315,0.5,2.0,1911.189734253363,110.4,8.362,52.061011,-290,0.9739442946990117
14,5,24,80,80,Glauchau,8371,51.62,21951,10739,11212,425,0.5,4.0,1225.0,110.3,12.542352,50.817863,-473,0.9578130574384588
9,7,71,113,113,Aichach,86551,92.83,21908,10642,11266,236,0.5,1.0,2414.2856486840537,110.5,11.133655,48.461439,-624,0.9446121072252796
9,7,80,139,139,Sonthofen,87527,46.55,21859,10482,11377,470,0.5,3.0,4239.5,110.5,10.281195,47.51239,-895,0.9213325129647535
6,4,36,4,4,Flörsheim am Main,65439,22.99,21851,10676,11175,950,0.5,2.0,3144.6597033712096,109.8,8.430161,50.013676,-499,0.9553467561521253
3,3,58,21,21,Soltau,29614,203.77,21808,10660,11148,107,0.5,2.0,2014.5,110.0,9.837525,52.987347,-488,0.9562253318980983
8,2,26,5004,32,Hockenheim,68766,34.84,21745,10773,10972,624,0.5,5.0,3086.871960079152,109.5,8.547437,49.318938,-199,0.9818629238060518
8,1,17,5003,19,Eislingen/Fils,73054,16.41,21745,10778,10967,1325,0.5,3.0,3635.887111979806,109.5,9.707697,48.700842,-189,0.9827664812619678
3,1,53,2,2,Bad Harzburg,38667,65.52,21738,10080,11658,332,0.5,2.0,1605.0,110.0,10.560048,51.880275,-1578,0.8646423057128152
9,1,83,128,128,Mühldorf a.Inn,84453,29.42,21697,10780,10917,737,0.5,1.0,3197.7856486840537,110.5,12.524963,48.241864,-137,0.9874507648621416
5,9,74,20,20,Geseke,59590,97.89,21685,10764,10921,222,0.5,4.0,2215.674582352709,110.4,8.508216,51.640122,-157,0.9856240271037451
8,3,15,5001,6,Bad Krozingen,79189,35.69,21684,10585,11099,608,0.5,1.0,4134.5,109.5,7.699949,47.916377,-514,0.9536895215785206
12,0,71,372,372,Spremberg/Grodk,3130,202.32,21585,10446,11139,107,0.5,3.0,1723.4471737441054,110.7,14.379761,51.571789,-693,0.9377861567465661
5,1,70,52,52,Xanten,46509,72.43,21582,10535,11047,298,0.5,3.0,2296.5,110.4,6.453197,51.662258,-512,0.9536525753598262
6,4,38,13,13,Seligenstadt,63500,30.85,21568,10375,11193,699,0.5,2.0,2935.1597033712096,109.8,8.972603,50.04432,-818,0.9269186098454392
6,5,34,18,18,Stadtallendorf,35260,78.24,21552,10678,10874,275,0.5,1.0,1941.0,109.8,9.016816,50.828131,-196,0.9819753540555454
15,0,82,430,430,Zerbst/Anhalt,39261,468.94,21519,10562,10957,46,0.5,2.0,1842.954749694436,110.7,12.085469,51.964039,-395,0.9639499863101214
1,0,58,43,43,Eckernförde,24340,21.58,21507,10193,11314,997,0.5,2.0,3625.0,109.4,9.837037,54.472791,-1121,0.9009192151316953
9,7,74,135,135,Günzburg,89312,55.4,21486,10597,10889,388,0.5,1.0,2620.2856486840537,110.5,10.281413,48.45447,-292,0.9731839471025806
5,7,74,16,16,Büren,33142,170.99,21483,11006,10477,126,0.5,3.0,1521.5,110.4,8.559696,51.554935,529,1.0504915529254557
5,1,54,44,44,Rees,46459,109.86,21475,10688,10787,195,0.5,1.0,2132.6973102036936,110.4,6.39621,51.759506,-99,0.9908222860851025
3,1,59,26,26,Osterode am Harz,37520,102.54,21446,10613,10833,209,0.5,4.0,2454.321228431276,110.0,10.248155,51.728407,-220,0.9796916828210098
8,2,15,106,106,Waghäusel,68753,42.84,21444,10647,10797,501,0.5,3.0,2939.387111979806,109.5,8.514287,49.250734,-150,0.9861072520144485
12,0,72,477,477,Zossen,15806,180.39,21433,11229,10204,119,0.5,3.0,3027.0,110.7,13.449172,52.21624,1025,1.1004508036064289
9,1,79,145,145,Puchheim,82178,12.24,21420,10393,11027,1750,0.5,1.0,4065.7856486840537,110.5,11.343959,48.148172,-634,0.9425047610410809
16,0,65,67,67,Sondershausen,99706,201.21,21317,10499,10818,106,0.5,2.0,1162.0,110.9,10.871992,51.368377,-319,0.9705121094472176
13,0,71,156,156,Waren (Müritz),17192,159.46,21267,9966,11301,133,0.5,2.0,1635.2197651355164,111.0,12.686242,53.513209,-1335,0.881868861162729
9,1,89,155,155,Traunstein,83278,48.57,21251,10267,10984,438,0.5,4.0,4457.0,110.5,12.632747,47.866152,-717,0.9347232337946103
3,4,58,14,14,Wildeshausen,27793,89.7,21154,10424,10730,236,0.5,1.0,2107.8439562822605,110.0,8.431942,52.894686,-306,0.9714818266542404
8,3,25,5005,53,Schramberg,78713,80.7,21125,10588,10537,262,0.5,2.0,2056.5,109.5,8.386187,48.225467,51,1.004840087311379
5,3,74,52,52,Wipperfürth,51688,118.3,21112,10509,10603,178,0.5,3.0,2306.6821583030323,110.4,7.398693,51.117041,-94,0.991134584551542
9,1,89,154,154,Traunreut,83301,45.06,21102,10434,10668,468,0.5,1.0,3602.0,110.5,12.593399,47.961596,-234,0.9780652418447694
5,1,58,36,36,Wülfrath,42489,32.27,21100,10229,10871,654,0.5,2.0,2641.689734253363,110.4,7.033183,51.280989,-642,0.9409437954190046
7,3,34,7,7,Germersheim,76726,21.68,21099,10652,10447,973,0.5,4.0,3031.0,109.8,8.374177,49.21765,205,1.0196228582368143
6,4,32,10,10,Groß-Umstadt,64823,86.84,21028,10411,10617,242,0.5,2.0,2441.6597033712096,109.8,8.926007,49.867962,-206,0.9805971555053217
5,3,66,44,44,Zülpich,53909,101.01,21025,10364,10661,208,0.5,2.0,2346.5,110.4,6.648155,50.691294,-297,0.9721414501453898
9,7,79,194,194,Nördlingen,86720,68.09,21009,10440,10569,309,0.5,4.0,2708.262920833069,110.5,10.49277,48.847442,-129,0.9877944933295487
8,4,16,5002,25,Mössingen,72116,50.03,20900,10167,10733,418,0.5,3.0,3220.0,109.5,9.057746,48.405779,-566,0.947265443026181
6,5,32,12,12,Herborn,35745,63.76,20894,10275,10619,328,0.5,2.0,2189.6597033712096,109.8,8.302982,50.682575,-344,0.9676052358979188
12,0,72,232,232,Luckenwalde,14943,46.61,20839,10148,10691,447,0.5,3.0,2300.0,110.7,13.173009,52.089253,-543,0.9492096155644935
6,4,35,6,6,Bruchköbel,63486,29.88,20825,10161,10664,697,0.5,1.0,2850.6672793215403,109.8,8.920577,50.178773,-503,0.9528319579894974
5,9,62,36,36,Meinerzhagen,58540,115.69,20812,10299,10513,180,0.5,1.0,1908.0,110.4,7.638497,51.107434,-214,0.9796442499762199
5,5,54,56,56,Stadtlohn,48703,79.25,20807,10413,10394,263,0.5,1.0,2066.6973102036936,110.4,6.918003,51.992602,19,1.0018279776794305
3,4,55,15,15,Schortens,26419,68.79,20797,10121,10676,302,0.5,7.0,1733.0,110.0,7.948406,53.540474,-555,0.9480142375421506
3,4,62,19,19,Wittmund,26409,210.16,20773,10163,10610,99,0.5,5.0,2098.313652480945,110.0,7.780018,53.575515,-447,0.9578699340245052
5,5,66,16,16,Hörstel,48477,107.54,20766,10413,10353,193,0.5,3.0,2090.5,110.4,7.587248,52.300221,60,1.0057954216169227
5,7,58,8,8,Enger,32130,41.24,20705,10210,10495,502,0.5,1.0,2055.6973102036936,110.4,8.559282,52.139237,-285,0.9728442115292997
14,5,24,300,300,Werdau,8412,65.62,20702,10285,10417,315,0.5,4.0,1018.5,110.3,12.378671,50.736044,-132,0.9873284054910243
6,4,35,21,21,Nidderau,61130,46.73,20700,10237,10463,443,0.5,2.0,2634.1597033712096,109.8,8.87606,50.220979,-226,0.9784000764599063
8,2,15,108,108,Rheinstetten,76287,32.31,20659,10057,10602,639,0.5,4.0,3724.5,109.5,8.292901,48.959096,-545,0.9485946047915488
8,4,36,5002,9,Bad Waldsee,88339,108.55,20630,10143,10487,190,0.5,1.0,2652.402263880467,109.5,9.751276,47.92251,-344,0.9671974825975017
7,3,38,25,25,Schifferstadt,67105,28.06,20615,10246,10369,735,0.5,1.0,3135.5,109.8,8.374595,49.385557,-123,0.9881377181984762
9,2,79,112,112,Dingolfing,84130,44.0,20607,10703,9904,468,0.5,1.0,2829.2856486840537,110.5,12.500422,48.62752,799,1.0806744749596122
5,9,78,12,12,Fröndenberg/Ruhr,58730,56.23,20548,10115,10433,365,0.5,3.0,2347.1821583030323,110.4,7.767252,51.473212,-318,0.9695197929646314
14,6,27,10,10,Coswig,1640,25.88,20512,9805,10707,793,0.5,2.0,2140.5,110.3,13.580494,51.126777,-902,0.9157560474455964
3,2,41,4,4,Burgwedel,30938,152.85,20506,9704,10802,134,0.5,2.0,2058.33638033193,110.0,9.856492,52.49202,-1098,0.8983521570079614
16,0,76,22,22,Greiz,7973,84.86,20397,9870,10527,240,0.5,2.0,964.5,110.9,12.201545,50.654739,-657,0.9375890567113138
14,5,23,5125,340,Reichenbach im Vogtland,8468,34.47,20371,9779,10592,591,0.5,2.0,1837.6013957730029,110.3,12.366175,50.620787,-813,0.9232439577039275
13,0,71,110,110,Neustrelitz,17235,139.89,20340,9763,10577,145,0.5,1.0,2002.0,111.0,13.062278,53.363118,-814,0.9230405597050203
3,1,59,10,10,Duderstadt,37115,95.64,20286,9949,10337,212,0.5,2.0,2367.33638033193,110.0,10.26116,51.512396,-388,0.9624649317983941
1,0,55,4,4,Bad Schwartau,23611,18.39,20255,9399,10856,1101,0.5,3.0,3240.0,109.4,10.695909,53.920431,-1457,0.8657885040530582
10,0,45,112,112,Blieskastel,66440,108.21,20240,9927,10313,187,0.5,2.0,2972.6296724890562,109.2,7.252923,49.23727,-386,0.962571511684282
5,5,66,68,68,Ochtrup,48607,105.63,20230,10275,9955,192,0.5,4.0,2191.674582352709,110.4,7.18865,52.208516,320,1.0321446509291814
5,5,70,44,44,Telgte,48291,90.9,20222,9815,10407,222,0.5,6.0,3042.5,110.4,7.784022,51.982866,-592,0.9431152109157298
9,4,78,139,139,Lichtenfels,96215,122.16,20217,9950,10267,165,0.5,1.0,2608.2856486840537,110.5,11.064046,50.146042,-317,0.9691243790786014
8,3,36,5007,81,Schopfheim,79650,67.93,20163,9752,10411,297,0.5,4.0,3415.0,109.5,7.822962,47.650141,-659,0.9367015656517146
8,1,35,5001,16,Giengen an der Brenz,89537,44.07,20133,10125,10008,457,0.5,1.0,3052.402263880467,109.5,10.24167,48.623783,117,1.0116906474820144
3,2,55,23,23,Holzminden,37603,88.24,20120,9956,10164,228,0.5,2.0,1234.5,110.0,9.447159,51.828764,-208,0.9795356158992523
16,0,61,115,115,Leinefelde-Worbis,37339,115.79,20119,9993,10126,174,0.5,2.0,1788.6314266551562,110.9,10.321641,51.387677,-133,0.9868654947659491
8,3,17,5009,89,Oberkirch,77704,69.1,20092,9998,10094,291,0.5,1.0,2945.0,109.5,8.077097,48.531805,-96,0.9904893996433525
16,0,66,63,63,Schmalkalden,98574,105.38,20065,10338,9727,190,0.5,1.0,2383.639002605487,110.9,10.45159,50.722559,611,1.0628148452760358
8,4,35,5006,57,Tettnang,88069,71.25,20037,9983,10054,281,0.5,4.0,4041.5,109.5,9.589453,47.671477,-71,0.9929381340759896
9,7,79,131,131,Donauwörth,86609,77.04,19994,9954,10040,260,0.0,2.0,2350.278072733723,110.5,10.777945,48.719139,-86,0.9914342629482071
10,0,44,111,111,Dillingen/ Saar,66763,22.05,19989,9811,10178,907,0.0,2.0,3474.6296724890562,109.2,6.726833,49.351599,-367,0.9639418353311063
8,1,25,5001,5,Bad Friedrichshall,74177,24.71,19962,10231,9731,808,0.0,1.0,3485.5,109.5,9.215882,49.229477,500,1.0513821806597472
8,1,18,80,80,Korntal-Münchingen,70825,20.71,19955,9938,10017,964,0.0,1.0,3149.902263880467,109.5,9.12377,48.826004,-79,0.9921134072077469
5,3,74,44,44,Waldbröl,51545,63.32,19949,9673,10276,315,0.0,4.0,1785.5,110.4,7.617394,50.876593,-603,0.9413195796029583
14,5,21,35,35,Aue-Bad Schlema,8280,36.43,19864,9500,10364,545,0.0,2.0,1530.1013957730029,110.3,12.700986,50.585486,-864,0.9166345040524894
8,1,18,19,19,Gerlingen,70839,17.01,19853,9761,10092,1167,0.0,4.0,5557.5,109.5,9.062047,48.800587,-331,0.9672017439556084
9,1,78,143,143,Moosburg a.d.Isar,85368,43.86,19832,9977,9855,452,0.0,3.0,2825.2704967833924,110.5,11.935504,48.467702,122,1.0123795027904616
9,7,73,125,125,Dillingen a.d.Donau,89407,75.59,19814,9789,10025,262,0.0,3.0,2393.7704967833924,110.5,10.496633,48.577159,-236,0.9764588528678304
14,7,30,5311,310,Torgau,4860,102.82,19802,9765,10037,193,0.0,2.0,1266.0,110.3,12.929244,51.563299,-272,0.9729002690046826
5,5,70,20,20,Ennigerloh,59320,125.56,19757,9846,9911,157,0.0,2.0,2005.689734253363,110.4,8.024092,51.835127,-65,0.9934416305115529
7,2,31,134,134,Wittlich,54516,49.64,19740,9919,9821,398,0.0,1.0,2421.5,109.8,6.889134,49.98627,98,1.0099786172487526
5,9,58,24,24,Marsberg,34431,182.22,19736,10165,9571,108,0.0,2.0,1371.689734253363,110.4,8.854984,51.459563,594,1.0620624804095706
3,2,54,28,28,Sarstedt,31157,43.0,19735,9735,10000,459,0.0,3.0,2391.5,110.0,9.855848,52.234449,-265,0.9735
7,1,37,68,68,Mayen,56727,58.19,19708,9807,9901,339,0.0,2.0,2456.1597033712096,109.8,7.222333,50.328707,-94,0.9905060094939905
1,0,56,44,44,Schenefeld,22869,9.99,19707,9548,10159,1973,0.0,5.0,4429.5,109.4,9.822462,53.600982,-611,0.9398562850674279
15,0,83,415,415,Oschersleben (Bode),39387,188.93,19704,9791,9913,104,0.0,2.0,1924.454749694436,110.7,11.227157,52.026437,-122,0.9876929284777565
3,2,57,9,9,Bückeburg,31675,68.9,19701,9490,10211,286,0.0,3.0,1902.5,110.0,9.050444,52.260372,-721,0.9293898736656547
6,5,32,11,11,Haiger,35708,106.73,19623,9715,9908,184,0.0,1.0,1796.1672793215403,109.8,8.204719,50.742898,-193,0.9805207912797739
9,1,87,117,117,Bad Aibling,83043,41.4,19613,9463,10150,474,0.0,3.0,5533.0,110.5,12.010474,47.863583,-687,0.9323152709359606
3,2,52,3,3,Bad Pyrmont,31812,61.99,19604,9341,10263,316,0.0,3.0,2223.828804381599,110.0,9.262908,51.985504,-922,0.9101627204521096
5,5,54,48,48,Rhede,46414,78.9,19595,9807,9788,248,0.0,5.0,2423.0,110.4,6.696075,51.840781,19,1.001941152431549
8,1,18,76,76,Sachsenheim,74343,57.92,19490,9611,9879,336,0.0,4.0,2762.8795360294826,109.5,9.063337,48.959506,-268,0.972871748152647
6,6,36,3,3,Eschwege,37269,63.26,19472,9329,10143,308,0.0,2.0,1440.5,109.8,10.057981,51.185804,-814,0.919747609188603
14,7,29,50,50,Borna,4552,62.45,19470,9361,10109,312,0.0,6.0,1421.0710919716876,110.3,12.49747,51.123285,-748,0.926006528835691
1,0,53,90,90,Mölln,23879,25.05,19469,9248,10221,777,0.0,4.0,2590.5,109.4,10.691022,53.629521,-973,0.9048038352411701
8,3,15,5012,74,Müllheim,79379,57.91,19463,9419,10044,336,0.0,2.0,2543.8946879301366,109.5,7.630871,47.808248,-625,0.9377737953006771
8,4,17,5004,31,Hechingen,72379,66.41,19439,9519,9920,293,0.0,3.0,1433.5,109.5,8.962947,48.351487,-401,0.9595766129032258
9,3,71,151,151,Sulzbach-Rosenberg,92237,53.12,19401,9626,9775,365,0.0,2.0,2654.778072733723,110.5,11.756146,49.495802,-149,0.9847570332480818
8,1,15,50,50,Weil der Stadt,71263,43.17,19401,9592,9809,449,0.0,2.0,3921.5,109.5,8.870105,48.751993,-217,0.9778774594759915
5,7,62,4,4,Bad Driburg,33014,115.3,19390,9627,9763,168,0.0,3.0,1646.1821583030323,110.4,9.017025,51.736124,-136,0.9860698555771792
14,5,21,20,20,Annaberg-Buchholz,9456,28.15,19382,9321,10061,689,0.0,3.0,1081.5,110.3,13.003162,50.580572,-740,0.9264486631547559
9,1,71,112,112,Burghausen,84489,19.81,19364,9504,9860,977,0.0,6.0,3386.247768932408,110.5,12.831282,48.168825,-356,0.963894523326572
12,0,63,208,208,Nauen,14641,268.14,19352,9617,9735,72,0.0,2.0,2828.5,110.7,12.876378,52.607013,-118,0.9878787878787879
5,3,70,36,36,Wassenberg,41849,42.43,19339,9523,9816,456,0.0,3.0,2297.1821583030323,110.4,6.155749,51.099533,-293,0.9701507742461287
9,1,73,147,147,Wolfratshausen,82515,9.13,19335,9443,9892,2118,0.0,4.0,5931.0,110.5,11.420767,47.912703,-449,0.9546097856854023
6,4,38,5,5,Heusenstamm,63150,19.03,19306,9530,9776,1015,0.0,2.0,3001.6597033712096,109.8,8.806283,50.059432,-246,0.974836333878887
15,0,83,270,270,Haldensleben,39340,156.31,19267,9464,9803,123,0.0,2.0,1530.5,110.7,11.411083,52.291363,-339,0.9654187493624401
7,3,31,3,3,Alzey,55232,35.22,19265,9482,9783,547,0.0,1.0,2442.1672793215403,109.8,8.112469,49.745225,-301,0.9692323418174384
14,7,30,270,270,Schkeuditz,4435,81.47,19189,9961,9228,236,0.0,5.0,1987.5,110.3,12.221712,51.396211,733,1.079432162982228
9,1,73,112,112,Bad Tölz,83646,30.8,19186,9243,9943,623,0.0,2.0,2909.778072733723,110.5,11.563912,47.759148,-700,0.9295987126621744
15,0,85,55,55,Blankenburg (Harz),38889,148.98,19161,9207,9954,129,0.0,3.0,1873.9471737441054,110.7,10.952601,51.791278,-747,0.9249547920433996
3,1,53,12,12,Seesen,38723,102.32,19159,9297,9862,187,0.0,3.0,2192.328804381599,110.0,10.176074,51.890957,-565,0.9427093895761509
16,0,68,51,51,Sömmerda,99610,87.56,19156,9414,9742,219,0.0,2.0,2351.1314266551562,110.9,11.118975,51.159368,-328,0.9663313487990146
3,3,58,19,19,Schneverdingen,29640,234.92,19140,9215,9925,81,0.0,2.0,2095.0,110.0,9.787463,53.118479,-710,0.9284634760705289
10,0,44,112,112,Lebach,66822,64.21,19095,9887,9208,297,0.0,4.0,2959.6145205884022,109.2,6.912464,49.410528,679,1.07374022589053
8,4,15,59,59,Pfullingen,72793,30.14,19005,9220,9785,631,0.0,2.0,3723.5,109.5,9.226443,48.466279,-565,0.9422585590189065
14,6,25,480,480,Radeberg,1454,29.83,18980,9253,9727,636,0.0,1.0,1692.1089717233335,110.3,13.921969,51.116404,-474,0.9512696617662177
5,3,78,8,8,Burscheid,51399,27.33,18968,9325,9643,694,0.0,1.0,2691.5,110.4,7.113704,51.085749,-318,0.9670227107746552
9,1,87,150,150,Kolbermoor,83059,19.83,18945,9190,9755,955,0.0,2.0,3302.778072733723,110.5,12.060928,47.85111,-565,0.9420809841107125
5,9,70,4,4,Bad Berleburg,57319,275.52,18923,9537,9386,69,0.0,1.0,1549.1973102036936,110.4,8.392854,51.049858,151,1.0160877903260175
12,0,73,452,452,Prenzlau,17291,142.97,18909,9027,9882,132,0.0,3.0,1650.5,110.7,13.707767,53.331298,-855,0.9134790528233151
9,1,72,114,114,Bad Reichenhall,83435,41.92,18893,9070,9823,451,0.0,2.0,2748.278072733723,110.5,12.876699,47.725886,-753,0.9233431741830398
3,2,41,7,7,Hemmingen,30966,31.73,18870,9078,9792,595,0.0,7.0,3124.5,110.0,9.747743,52.32069,-714,0.9270833333333334
9,5,77,177,177,Weißenburg i.Bay.,91781,97.58,18854,9257,9597,193,0.0,2.0,2441.778072733723,110.5,10.971667,49.030107,-340,0.9645722621652599
9,6,71,111,111,Alzenau,63755,59.3,18829,9208,9621,318,0.0,2.0,3111.0,110.5,9.071865,50.08681,-413,0.9570730693275127
7,3,32,2,2,Bad Dürkheim,67098,102.55,18818,8843,9975,184,0.0,3.0,2340.152127420879,109.8,8.169191,49.460397,-1132,0.886516290726817
9,7,77,151,151,Marktoberdorf,87616,95.15,18809,9455,9354,198,0.0,2.0,3311.0,110.5,10.618465,47.779483,101,1.0107975197776353
3,3,57,8,8,Bremervörde,27432,150.42,18793,9414,9379,125,0.0,2.0,1842.3363803319298,110.0,9.146245,53.485106,35,1.0037317411237872
3,2,54,2,2,Alfeld (Leine),31061,72.88,18723,9220,9503,257,0.0,2.0,1431.5,110.0,9.825738,51.987221,-283,0.970219930548248
5,3,74,4,4,Bergneustadt,51702,37.89,18633,9031,9602,492,0.0,2.0,2413.189734253363,110.4,7.648337,51.021118,-571,0.9405332222453655
1,0,56,49,49,Uetersen,25436,11.43,18618,9123,9495,1629,0.0,3.0,2995.5,109.4,9.711965,53.697658,-372,0.9608214849921011
8,1,15,41,41,Renningen,71272,31.15,18596,9217,9379,597,0.0,3.0,2888.387111979806,109.5,8.936373,48.765313,-162,0.9827273696556136
14,5,24,5104,30,Crimmitschau,8451,61.15,18567,9005,9562,304,0.0,3.0,931.0,110.3,12.386924,50.81245,-557,0.9417485881614724
1,0,62,18,18,Glinde,21509,11.21,18547,9107,9440,1655,0.0,2.0,3727.806349449769,109.4,10.211314,53.540087,-333,0.9647245762711865
6,4,36,6,6,Hochheim am Main,65239,19.47,18538,9124,9414,952,0.0,3.0,3005.152127420879,109.8,8.353313,50.01113,-290,0.9691948162311451
5,7,58,36,36,Vlotho,32602,76.93,18495,9263,9232,240,0.0,2.0,1567.5,110.4,8.860068,52.165489,31,1.0033578856152514
6,6,34,22,22,Schwalmstadt,34613,84.79,18488,9366,9122,218,0.0,2.0,1832.6597033712096,109.8,9.188384,50.912032,244,1.02674852006139
6,6,33,26,26,Vellmar,34246,13.97,18474,8787,9687,1322,0.0,4.0,2428.0,109.8,9.478272,51.355424,-900,0.9070919789408486
3,2,52,7,7,Hessisch Oldendorf,31840,120.32,18458,9052,9406,153,0.0,2.0,1967.3363803319298,110.0,9.252506,52.168347,-354,0.9623644482245375
7,1,41,75,75,Lahnstein,56112,37.62,18433,8906,9527,490,0.0,2.0,2458.5,109.8,7.607337,50.300468,-621,0.9348168363598195
6,4,34,6,6,Kronberg im Taunus,61476,18.58,18416,8708,9708,991,0.0,3.0,3020.652127420879,109.8,8.510666,50.179718,-1000,0.8969921714050267
7,2,35,5003,68,Konz,54329,44.57,18403,8989,9414,413,0.0,2.0,2376.1597033712096,109.8,6.576553,49.694664,-425,0.9548544720628851
8,4,37,5006,104,Sigmaringen,72488,92.84,18375,9468,8907,198,0.0,2.0,2384.3946879301366,109.5,9.214788,48.086623,561,1.062984169754126
9,7,75,129,129,Illertissen,89257,36.39,18368,9048,9320,505,0.0,1.0,3214.0,110.5,10.10286,48.222701,-272,0.9708154506437768
7,3,34,501,501,Wörth am Rhein,76744,131.62,18350,9030,9320,139,0.0,1.0,2522.1672793215403,109.8,8.268634,49.051938,-290,0.9688841201716738
10,0,41,515,515,Püttlingen,66346,23.95,18295,8828,9467,764,0.0,1.0,1803.5,109.2,6.884983,49.287743,-639,0.9325023766768775
13,0,76,108,108,Parchim,19370,124.81,18278,8831,9447,146,0.0,1.0,1444.727341085847,111.0,11.847644,53.425581,-616,0.9347941145337144
1,0,60,5,5,Bad Segeberg,23795,18.87,18221,8879,9342,966,0.0,1.0,2630.5,109.4,10.304193,53.937059,-463,0.950438878184543
14,6,27,60,60,Großenhain,1558,130.36,18102,8874,9228,139,0.0,1.0,974.6089717233335,110.3,13.53055,51.292057,-354,0.9616384915474643
9,7,72,125,125,Bobingen,86399,50.26,18070,8928,9142,360,0.0,3.0,3884.5,110.5,10.835456,48.271966,-214,0.9765915554583242
6,6,35,11,11,Frankenberg (Eder),35066,124.86,18033,9024,9009,144,0.0,4.0,1846.1445514705556,109.8,8.799233,51.058731,15,1.0016650016650017
8,2,25,14,14,Buchen (Odenwald),74722,138.93,18018,8785,9233,130,0.0,2.0,2412.3946879301366,109.5,9.323179,49.521795,-448,0.9514783927217589
6,5,31,14,14,Pohlheim,35415,38.0,18003,8869,9134,474,0.0,3.0,2397.5,109.8,8.716165,50.534353,-265,0.9709875191591855
9,2,75,154,154,Vilshofen an der Donau,94474,86.29,17960,8916,9044,208,0.0,2.0,2588.278072733723,110.5,13.184559,48.634144,-128,0.9858469703670942
12,0,71,76,76,Forst (Lausitz)/Baršć (Łužyca),3149,110.69,17855,8647,9208,161,0.0,2.0,1458.954749694436,110.7,14.644601,51.744632,-561,0.9390747176368376
5,9,62,60,60,Werdohl,58791,33.38,17827,8775,9052,534,0.0,2.0,1441.0,110.4,7.766853,51.259614,-277,0.9693990278391516
9,1,72,118,118,Freilassing,83395,14.81,17816,8700,9116,1203,0.0,3.0,3449.2704967833924,110.5,12.978135,47.842101,-416,0.9543659499780606
9,5,73,122,122,Oberasbach,90522,12.08,17810,8567,9243,1474,0.0,1.0,3514.7856486840537,110.5,10.958495,49.422443,-676,0.9268635724331927
5,9,70,16,16,Freudenberg,57258,54.6,17773,8819,8954,326,0.0,1.0,2097.5,110.4,7.876633,50.897439,-135,0.984922939468394
14,5,23,20,20,Auerbach/Vogtl.,8209,55.52,17759,8569,9190,320,0.0,2.0,1316.1013957730029,110.3,12.402307,50.508726,-621,0.9324265505984766
9,1,85,158,158,Schrobenhausen,86529,75.26,17754,8783,8971,236,0.0,2.0,4010.0,110.5,11.264967,48.561245,-188,0.9790435848846283
3,2,52,2,2,Bad Münder am Deister,31848,107.97,17728,8666,9062,164,0.0,1.0,1940.8439562822605,110.0,9.463755,52.197773,-396,0.9563010372986096
8,4,37,5005,100,Bad Saulgau,88348,97.34,17702,8717,8985,182,0.0,4.0,2559.5,109.5,9.593584,48.028386,-268,0.9701725097384529
3,2,51,12,12,Diepholz,49356,104.7,17685,8675,9010,169,0.0,1.0,2129.3439562822605,110.0,8.370605,52.606393,-335,0.962819089900111
8,3,37,5005,96,Bad Säckingen,79713,25.35,17660,8494,9166,697,0.0,1.0,2997.402263880467,109.5,7.948758,47.552535,-672,0.9266855771328824
6,4,40,16,16,Nidda,63667,118.33,17650,8867,8783,149,0.0,3.0,1939.5,109.8,9.006592,50.413675,84,1.0095639303199362
10,0,45,111,111,Bexbach,66450,31.09,17642,8626,9016,567,0.0,1.0,3135.137248439387,109.2,7.257578,49.347836,-390,0.9567435669920142
3,4,60,2,2,Damme,49401,104.39,17639,8749,8890,169,0.0,1.0,2140.0,110.0,8.196486,52.521308,-141,0.9841394825646794
6,6,35,3,3,Bad Wildungen,34537,120.1,17595,8648,8947,147,0.0,3.0,1812.152127420879,109.8,9.124808,51.119966,-299,0.9665809768637532
8,3,27,5005,49,Trossingen,78647,24.2,17571,8862,8709,726,0.0,2.0,2619.5,109.5,8.632659,48.074438,153,1.0175680330692387
9,1,84,119,119,Garching b.München,85748,28.17,17526,9011,8515,622,0.0,1.0,2906.7856486840537,110.5,11.65188,48.249173,496,1.0582501467997651
8,3,35,5006,79,Stockach,78333,69.73,17490,8601,8889,251,0.0,1.0,3064.5,109.5,9.00899,47.848855,-288,0.9676004049949376
7,1,31,77,77,Sinzig,53489,41.1,17437,8509,8928,424,0.0,1.0,2446.1672793215403,109.8,7.249122,50.54387,-419,0.9530689964157706
7,1,31,70,70,Remagen,53424,33.21,17426,8631,8795,525,0.0,2.0,2759.5,109.8,7.234403,50.577781,-164,0.9813530415008528
9,3,72,116,116,Cham,93413,80.69,17421,8691,8730,216,0.0,1.0,2454.7856486840537,110.5,12.667061,49.219124,-39,0.99553264604811
6,4,32,2,2,Babenhausen,64832,66.85,17409,8644,8765,260,0.0,5.0,2686.0,109.8,8.95236,49.962864,-121,0.9861950941243582
6,4,33,7,7,Kelsterbach,65451,15.41,17375,8970,8405,1128,0.0,2.0,3056.6597033712096,109.8,8.528848,50.06318,565,1.0672218917311125
5,5,54,16,16,Gescher,48712,80.84,17361,8733,8628,215,0.0,3.0,2093.5,110.4,7.005391,51.955894,105,1.0121696801112656
16,0,64,3,3,Bad Langensalza,99947,129.37,17349,8450,8899,134,0.0,4.0,2295.6162747545022,110.9,10.649839,51.106785,-449,0.9495448926845713
1,0,53,116,116,Schwarzenbek,21493,11.65,17317,8521,8796,1486,0.0,6.0,3757.276045648454,109.4,10.477663,53.502645,-275,0.9687357889949977
5,7,66,32,32,Horn-Bad Meinberg,32805,90.15,17290,8439,8851,192,0.0,2.0,1537.5,110.4,8.945418,51.87278,-412,0.9534515873912552
5,3,66,4,4,Bad Münstereifel,53902,150.83,17282,8341,8941,115,0.0,1.0,1925.6973102036936,110.4,6.765111,50.556858,-600,0.932893412369981
9,5,77,136,136,Gunzenhausen,91710,82.72,17239,8346,8893,208,0.0,6.0,2640.0,110.5,10.759225,49.113471,-547,0.9384909479365793
5,7,66,56,56,Oerlinghausen,33813,32.69,17238,8366,8872,527,0.0,3.0,2102.6821583030323,110.4,8.66135,51.952315,-506,0.9429666366095582
16,0,61,45,45,Heilbad Heiligenstadt,37308,70.87,17233,8601,8632,243,0.0,2.0,2111.5,110.9,10.137999,51.378474,-31,0.9964087117701576
7,1,37,203,203,Bendorf,56170,24.12,17221,8503,8718,714,0.0,1.0,2833.1672793215403,109.8,7.575608,50.423567,-215,0.9753383803624684
9,4,79,136,136,Marktredwitz,95615,49.52,17206,8322,8884,347,0.0,1.0,2654.7856486840537,110.5,12.086076,50.001792,-562,0.9367402071139127
9,7,78,116,116,Bad Wörishofen,86825,57.79,17180,8273,8907,297,0.0,2.0,3552.0,110.5,10.592777,48.002989,-634,0.9288200291905243
6,4,39,3,3,Eltville am Rhein,65343,46.77,17112,8283,8829,366,0.0,1.0,2420.1672793215403,109.8,8.119535,50.024896,-546,0.9381583418280666
1,0,55,12,12,Eutin,23701,41.38,17086,8044,9042,413,0.0,2.0,2754.0,109.4,10.614962,54.138933,-998,0.8896261888962619
9,2,73,137,137,Kelheim,93309,100.23,17044,8474,8570,170,0.0,2.0,2860.0,110.5,11.869879,48.919056,-96,0.9887981330221703
14,6,25,250,250,Kamenz / Kamjenc,1917,98.3,17015,8483,8532,173,0.0,7.0,1381.563516021357,110.3,14.098251,51.270734,-49,0.9942569151429911
6,4,33,5,5,Ginsheim-Gustavsburg,65462,13.94,16960,8366,8594,1217,0.0,2.0,3172.1597033712096,109.8,8.345195,49.966981,-228,0.9734698626949034
6,6,31,15,15,Hünfeld,36088,119.75,16941,8579,8362,141,0.0,1.0,1908.5,109.8,9.769026,50.672895,217,1.0259507294905525
9,4,76,145,145,Kronach,96317,66.98,16906,8278,8628,252,0.0,1.0,2541.7856486840537,110.5,11.325279,50.239015,-350,0.9594343996291145
14,6,28,160,160,Heidenau,1809,11.07,16884,8302,8582,1525,0.0,5.0,2456.5,110.3,13.863536,50.980894,-280,0.967373572593801
15,0,85,330,330,Thale,6502,137.67,16868,8265,8603,123,0.0,1.0,1568.4623256447667,110.7,11.045799,51.753943,-338,0.9607113797512495
7,2,32,18,18,Bitburg,54634,47.55,16852,8283,8569,354,0.0,2.0,2587.0,109.8,6.524756,49.975769,-286,0.9666238767650834
12,0,70,424,424,Wittenberge,19322,50.63,16837,8173,8664,333,0.0,4.0,2090.939597793782,110.7,11.751411,52.993574,-491,0.9433287165281625
5,7,74,8,8,Bad Lippspringe,33175,51.01,16808,8154,8654,330,0.0,1.0,2407.0,110.4,8.818502,51.782341,-500,0.9422232493644558
6,4,34,5,5,Königstein im Taunus,61462,25.05,16744,7947,8797,668,0.0,1.0,2639.1672793215403,109.8,8.464874,50.182742,-850,0.9033761509605547
6,4,31,5,5,Bürstadt,68642,34.46,16734,8254,8480,486,0.0,3.0,2593.152127420879,109.8,8.45334,49.640458,-226,0.9733490566037736
9,1,90,141,141,Penzberg,82377,25.73,16729,8186,8543,650,0.0,4.0,5479.5,110.5,11.376279,47.751761,-357,0.958211401147138
8,4,25,141,141,Blaustein,89134,55.61,16667,8443,8224,300,0.0,4.0,2819.3795360294826,109.5,9.921863,48.416145,219,1.0266293774319066
3,2,51,7,7,Bassum,27211,168.85,16658,8289,8369,99,0.0,1.0,1899.5,110.0,8.725552,52.847957,-80,0.9904409128928188
14,7,29,410,410,Wurzen,4808,69.0,16614,8027,8587,241,0.0,5.0,1493.0786679220182,110.3,12.872916,51.397925,-560,0.9347851403284034
14,5,21,390,390,Marienberg,9496,133.49,16603,8230,8373,124,0.0,1.0,1210.6089717233335,110.3,13.159828,50.651644,-143,0.9829212946375254
6,4,32,19,19,Reinheim,64354,27.7,16603,8200,8403,599,0.0,1.0,2740.0,109.8,8.834738,49.826054,-203,0.9758419612043318
6,4,33,10,10,Raunheim,65479,12.6,16542,8380,8162,1313,0.0,3.0,3283.652127420879,109.8,8.452933,50.013579,218,1.026709139916687
8,1,25,5003,13,Brackenheim,74336,45.75,16521,8329,8192,361,0.0,3.0,3319.0,109.5,9.064886,49.078235,137,1.0167236328125
6,5,34,11,11,Kirchhain,35274,90.95,16462,8090,8372,181,0.0,2.0,1867.1597033712096,109.8,8.921032,50.820738,-282,0.9663162924032489
5,9,62,4,4,Altena,58762,44.42,16430,8145,8285,370,0.0,6.0,1211.0,110.4,7.67459,51.298662,-140,0.9831019915509958
5,9,62,28,28,Kierspe,58566,71.91,16422,8046,8376,228,0.0,6.0,2079.1594304520477,110.4,7.586453,51.136194,-330,0.9606017191977078
9,2,75,141,141,Pocking,94060,68.86,16399,8004,8395,238,0.0,3.0,2677.2704967833924,110.5,13.310359,48.400369,-391,0.9534246575342465
5,7,62,16,16,Brakel,33034,173.92,16372,8178,8194,94,0.0,3.0,1261.5,110.4,9.184377,51.716841,-16,0.9980473517207713
5,1,54,52,52,Straelen,47638,74.0,16365,8144,8221,221,0.0,2.0,2067.689734253363,110.4,6.266608,51.444776,-77,0.9906337428536675
12,0,71,160,160,Guben,3172,43.99,16363,7728,8635,372,0.0,5.0,1527.0,110.7,14.712014,51.954129,-907,0.8949623624782861
10,0,41,518,518,Sulzbach/ Saar,66280,16.07,16353,8019,8334,1018,0.0,1.0,3717.637248439387,109.2,7.060058,49.29895,-315,0.9622030237580994
5,9,62,12,12,Halver,58553,77.23,16347,8021,8326,212,0.0,1.0,1821.6973102036936,110.4,7.497997,51.186749,-305,0.9633677636319962
5,9,74,16,16,Erwitte,59597,89.41,16333,8031,8302,183,0.0,2.0,1984.0,110.4,8.336195,51.611473,-271,0.9673572633100458
1,0,62,6,6,Bargteheide,22941,15.82,16301,7799,8502,1030,0.0,1.0,3169.3139254001,109.4,10.261922,53.730088,-703,0.917313573276876
8,1,16,5009,71,Wendlingen am Neckar,73240,12.15,16258,8051,8207,1338,0.0,2.0,3448.8946879301366,109.5,9.379528,48.672462,-156,0.9809918362373583
3,4,56,1,1,Bad Bentheim,48455,100.0,16251,8053,8198,163,0.0,1.0,1919.5,110.0,7.159614,52.302515,-145,0.9823127592095633
8,1,26,5003,46,Künzelsau,74653,75.17,16228,8186,8042,216,0.0,4.0,2577.8795360294826,109.5,9.654049,49.299402,144,1.0179059935339467
8,1,18,5004,78,Freiberg am Neckar,71691,13.14,16216,7911,8305,1234,0.0,2.0,4312.0,109.5,9.195537,48.933909,-394,0.9525586995785671
6,5,35,1,1,Alsfeld,36304,129.71,16177,7996,8181,125,0.0,4.0,1888.6445514705556,109.8,9.271415,50.751031,-185,0.9773866275516441
6,4,35,25,25,Schlüchtern,36381,113.3,16151,8003,8148,143,0.0,4.0,1820.0,109.8,9.524202,50.347107,-145,0.9822042218949435
14,7,29,270,270,Markranstädt,4420,58.46,16132,7916,8216,276,0.0,1.0,1258.6089717233335,110.3,12.220204,51.301272,-300,0.9634858812074002
6,4,37,11,11,Michelstadt,64720,86.98,16097,7975,8122,185,0.0,2.0,2044.5,109.8,9.004011,49.679443,-147,0.9819010096035459
8,1,18,5005,49,Marbach am Neckar,71672,18.06,16053,7840,8213,889,0.0,3.0,3099.387111979806,109.5,9.259828,48.939832,-373,0.9545841957871667
14,7,30,110,110,Eilenburg,4838,46.85,16031,7676,8355,342,0.0,4.0,1408.5862438723489,110.3,12.740395,51.499031,-679,0.9187312986235787
1,0,57,62,62,Preetz,24211,14.4,16024,7611,8413,1113,0.0,2.0,2797.5,109.4,10.280512,54.231866,-802,0.9046713419707595
16,0,76,5054,87,Zeulenroda-Triebes,7937,135.14,16021,7777,8244,119,0.0,2.0,1243.1314266551562,110.9,11.953584,50.634631,-467,0.9433527413876759
3,4,57,21,21,Weener,26826,81.23,15997,7978,8019,197,0.0,3.0,1757.5,110.0,7.349834,53.165511,-41,0.9948871430352911
6,6,35,2,2,Bad Arolsen,34454,126.47,15987,7940,8047,126,0.0,2.0,1733.6597033712096,109.8,9.017086,51.38002,-107,0.9867031191748478
9,7,77,129,129,Füssen,87629,43.5,15985,7597,8388,367,0.0,3.0,4221.0,110.5,10.70045,47.569686,-791,0.9056986170720076
6,4,35,7,7,Erlensee,63526,18.58,15969,8007,7962,859,0.0,2.0,2841.6597033712096,109.8,8.97813,50.171489,45,1.0056518462697814
12,0,62,140,140,Finsterwalde,3238,77.52,15968,7646,8322,206,0.0,1.0,1525.0,110.7,13.707896,51.629598,-676,0.9187695265561163
14,5,21,550,550,Schwarzenberg/Erzgeb.,8340,46.31,15936,7663,8273,344,0.0,2.0,1610.6013957730029,110.3,12.784811,50.537823,-610,0.926266167049438
3,1,54,13,13,Königslutter am Elm,38154,131.13,15933,7879,8054,122,0.0,4.0,1880.0,110.0,10.816117,52.252332,-175,0.9782716662527936
8,2,26,95,95,Walldorf,69190,19.91,15892,7796,8096,798,0.0,5.0,3205.371960079152,109.5,8.642764,49.303151,-300,0.9629446640316206
10,0,42,116,116,Wadern,66687,111.14,15885,7926,7959,143,0.0,1.0,1527.0,109.2,6.890001,49.53951,-33,0.9958537504711648
5,5,70,16,16,Drensteinfurt,48317,106.6,15874,7846,8028,149,0.0,5.0,2041.6670064023783,110.4,7.741663,51.797048,-182,0.9773293472845043
14,7,30,300,300,Taucha,4425,33.22,15816,7618,8198,476,0.0,5.0,2550.5,110.3,12.501717,51.38173,-580,0.9292510368382533
8,3,15,5002,15,Breisach am Rhein,79206,54.59,15793,7771,8022,289,0.0,1.0,2411.902263880467,109.5,7.583227,48.031142,-251,0.968711044627275
5,7,70,40,40,Rahden,32369,137.48,15773,7945,7828,115,0.0,1.0,1711.5,110.4,8.613029,52.432924,117,1.014946346448646
12,0,66,196,196,Lübbenau/Spreewald / Lubnjow/Błota,3222,139.51,15726,7695,8031,113,0.0,2.0,1415.454749694436,110.7,13.968659,51.868584,-336,0.9581621217781098
13,0,73,5361,75,Ribnitz-Damgarten,18311,122.83,15721,7430,8291,128,0.0,1.0,2301.5,111.0,12.431833,54.243021,-861,0.896152454468701
9,5,74,112,112,Altdorf b.Nürnberg,90518,48.59,15700,7757,7943,323,0.0,2.0,2521.278072733723,110.5,11.354924,49.385516,-186,0.976583154979227
6,4,32,4,4,Dieburg,64807,23.08,15699,7664,8035,680,0.0,6.0,3335.5,109.8,8.840041,49.899272,-371,0.9538270068450528
8,1,17,5002,18,Ebersbach an der Fils,73061,26.26,15692,7788,7904,598,0.0,2.0,2775.8946879301366,109.5,9.523452,48.714242,-116,0.9853238866396761
9,7,78,173,173,Mindelheim,87719,56.42,15654,7828,7826,277,0.0,2.0,3533.0,110.5,10.491139,48.047279,2,1.0002555583950932
8,4,25,5008,72,Langenau,89129,75.03,15633,7872,7761,208,0.0,1.0,2465.902263880467,109.5,10.121087,48.499499,111,1.014302280633939
7,1,40,501,501,Boppard,56154,74.88,15616,7592,8024,209,0.0,3.0,1948.5,109.8,7.590758,50.231624,-432,0.9461615154536391
12,0,73,572,572,Templin,17268,379.59,15599,7511,8088,41,0.0,3.0,2149.0,110.7,13.607102,53.264349,-577,0.9286597428288823
9,6,73,114,114,Bad Neustadt a.d.Saale,97616,36.9,15558,7617,7941,422,0.0,1.0,2602.7856486840537,110.5,10.206512,50.329758,-324,0.9591990933131848
8,2,26,18,18,Eppelheim,69214,5.7,15555,7672,7883,2729,0.0,2.0,4694.894687930137,109.5,8.631011,49.401236,-211,0.973233540530255
6,6,33,13,13,Hofgeismar,34369,86.37,15521,7539,7982,180,0.0,4.0,1564.5,109.8,9.383496,51.494179,-443,0.9445001252818842
6,4,36,11,11,Schwalbach am Taunus,65824,6.47,15519,7512,8007,2399,0.0,1.0,4188.16727932154,109.8,8.537789,50.149333,-495,0.9381790932933683
9,7,72,202,202,Stadtbergen,86391,11.49,15488,7528,7960,1348,0.0,4.0,3439.762920833069,110.5,10.845885,48.36738,-432,0.9457286432160804
9,2,73,147,147,Mainburg,84048,61.54,15466,7807,7659,251,0.0,1.0,3238.5,110.5,11.779914,48.640936,148,1.0193236714975846
1,0,55,32,32,Neustadt in Holstein,23730,19.73,15464,7269,8195,784,0.0,2.0,2988.806349449769,109.4,10.816351,54.10563,-926,0.8870042708968884
3,2,41,6,6,Gehrden,30989,43.27,15426,7390,8036,357,0.0,2.0,3013.0,110.0,9.59892,52.315068,-646,0.9196117471378795
5,7,66,16,16,Blomberg,32825,99.1,15407,7737,7670,155,0.0,3.0,1672.1821583030323,110.4,9.091039,51.943469,67,1.008735332464146
3,3,58,16,16,Munster,29633,194.52,15366,7842,7524,79,0.0,2.0,1598.5,110.0,10.092879,52.986508,318,1.0422647527910687
1,0,60,4,4,Bad Bramstedt,24576,24.14,15331,7482,7849,635,0.0,1.0,2811.3139254001,109.4,9.882266,53.918819,-367,0.9532424512676774
3,1,53,18,18,Clausthal-Zellerfeld,38678,43.69,15286,8511,6775,350,0.0,3.0,1134.5,110.0,10.333189,51.803755,1736,1.2562361623616236
6,4,32,16,16,Ober-Ramstadt,64372,41.88,15252,7509,7743,364,0.0,4.0,2497.6445514705556,109.8,8.7395,49.831768,-234,0.9697791553661371
9,1,77,115,115,Dorfen,84405,99.56,15179,7586,7593,152,0.0,2.0,4500.0,110.5,12.154454,48.271966,-7,0.9990780982483867
9,6,77,155,155,Lohr a.Main,97816,90.42,15168,7544,7624,168,0.0,1.0,2379.7856486840537,110.5,9.575872,49.993219,-80,0.9895068205666316
14,6,26,5242,600,Weißwasser/O.L.,2943,63.43,15136,7211,7925,239,0.0,2.0,1385.3513957730029,110.3,14.575506,51.404654,-714,0.9099053627760252
3,4,61,2,2,Brake (Unterweser),26919,38.3,15094,7387,7707,394,0.0,1.0,1489.5,110.0,8.478138,53.326342,-320,0.9584793045283508
8,2,26,82,82,Schriesheim,69198,31.61,15091,7309,7782,477,0.0,2.0,3559.0,109.5,8.664038,49.47608,-473,0.939218709843228
9,4,73,151,151,Neustadt b.Coburg,96465,61.89,15064,7443,7621,243,0.0,1.0,2516.2856486840537,110.5,11.122297,50.327062,-178,0.9766434851069413
8,4,36,10,10,Bad Wurzach,88410,182.24,15061,7644,7417,83,0.0,1.0,2874.0,109.5,9.896525,47.908416,227,1.030605366050964
8,1,18,50,50,Markgröningen,71706,28.17,15054,7540,7514,534,0.0,4.0,2905.1295360294826,109.5,9.081072,48.905178,26,1.0034602076124568
3,1,53,19,19,Langelsheim,38685,108.76,15043,7476,7567,138,0.0,2.0,1144.5,110.0,10.335897,51.938286,-91,0.9879740980573543
6,6,34,5,5,Fritzlar,34560,88.81,15031,7366,7665,169,0.0,1.0,1760.9172793215403,109.8,9.275373,51.13094,-299,0.9609915198956295
15,0,88,195,195,Landsberg,6188,125.44,15015,7497,7518,120,0.0,1.0,1796.0,110.7,12.15883,51.525359,-21,0.9972067039106145
6,6,36,16,16,Witzenhausen,37213,126.78,15005,7257,7748,118,0.0,1.0,1742.9172793215403,109.8,9.858869,51.341392,-491,0.9366288074341765
9,6,77,148,148,Karlstadt,97753,98.15,14995,7391,7604,153,0.0,4.0,2235.0,110.5,9.764132,49.962153,-213,0.9719884271436087
6,4,34,11,11,Usingen,61250,55.81,14926,7325,7601,267,0.0,2.0,2290.4097033712096,109.8,8.537436,50.333557,-276,0.9636889882910143
3,4,55,7,7,Jever,26441,42.23,14847,7013,7834,352,0.0,2.0,2075.0,110.0,7.900312,53.575606,-821,0.8952004084758743
8,4,36,49,49,Isny im Allgäu,88316,85.39,14835,7385,7450,174,0.0,2.0,2624.8946879301366,109.5,10.039361,47.692238,-65,0.991275167785235
5,3,74,16,16,Hückeswagen,42499,50.52,14825,7402,7423,293,0.0,3.0,2252.5,110.4,7.334939,51.14861,-21,0.9971709551394315
9,7,72,200,200,Schwabmünchen,86830,55.5,14819,7267,7552,267,0.0,1.0,2334.0356486840537,110.5,10.757701,48.179039,-285,0.9622616525423728
3,2,41,13,13,Pattensen,30982,67.12,14790,7177,7613,220,0.0,1.0,2520.0,110.0,9.761472,52.26395,-436,0.9427295415736241
5,9,70,20,20,Hilchenbach,57271,81.12,14775,7286,7489,182,0.0,3.0,1923.6821583030323,110.4,8.113101,50.995897,-203,0.9728935772466284
9,4,79,152,152,Selb,95100,86.07,14763,7145,7618,172,0.0,4.0,1300.0,110.5,12.13074,50.169756,-473,0.9379102126542399
8,4,15,5003,53,Münsingen,72525,116.93,14755,7250,7505,126,0.0,2.0,2174.6446879301366,109.5,9.494863,48.411369,-255,0.966022651565623
9,2,73,152,152,Neustadt a.d.Donau,93333,93.53,14714,7532,7182,157,0.0,1.0,2445.7856486840537,110.5,11.763524,48.80909,350,1.0487329434697856
8,2,15,97,97,Kraichtal,76703,80.59,14699,7312,7387,182,0.0,4.0,2586.0,109.5,8.714528,49.122597,-75,0.989847028563693
8,3,25,5002,45,Oberndorf am Neckar,78727,55.92,14662,7291,7371,262,0.0,1.0,2456.402263880467,109.5,8.57303,48.289033,-80,0.9891466558133225
8,1,16,5006,56,Plochingen,73207,10.64,14611,7289,7322,1373,0.0,2.0,4141.5,109.5,9.41695,48.713282,-33,0.9954930346899754
6,4,35,17,17,Langenselbold,63505,26.23,14608,7141,7467,557,0.0,1.0,2553.6672793215403,109.8,9.039698,50.175668,-326,0.9563412347663051
7,1,43,5004,48,Montabaur,56410,33.77,14595,7098,7497,432,0.0,2.0,2442.0,109.8,7.827159,50.436232,-399,0.9467787114845938
8,1,28,139,139,Lauda-Königshofen,97922,94.44,14578,7242,7336,154,0.0,2.0,2829.1446879301366,109.5,9.70108,49.57011,-94,0.987186477644493
9,5,73,127,127,Stein,90547,19.51,14556,6926,7630,746,0.0,2.0,3810.0,110.5,11.015582,49.414352,-704,0.9077326343381389
1,0,53,100,100,Ratzeburg,23909,30.29,14553,6870,7683,480,0.0,1.0,2692.8139254001,109.4,10.774492,53.699024,-813,0.8941819601718078
14,6,28,410,410,Wilsdruff,1723,81.6,14551,7193,7358,178,0.0,3.0,2052.0,110.3,13.537465,51.052092,-165,0.9775754281054635
10,0,43,115,115,Ottweiler,66564,45.56,14543,7259,7284,319,0.0,5.0,3069.3569446380716,109.2,7.16207,49.402493,-25,0.9965678198791873
9,2,73,111,111,Abensberg,93326,60.26,14534,7440,7094,241,0.0,3.0,3310.0,110.5,11.848622,48.81553,346,1.0487736115026782
9,7,80,124,124,Immenstadt i.Allgäu,87509,81.44,14512,6977,7535,178,0.0,3.0,2361.5204967833924,110.5,10.218869,47.560431,-558,0.9259455872594559
6,4,34,7,7,Neu-Anspach,61267,36.12,14512,7124,7388,402,0.0,1.0,2374.1672793215403,109.8,8.506889,50.291757,-264,0.9642663779101245
5,9,58,36,36,Olsberg,59939,118.0,14509,7150,7359,123,0.0,3.0,1541.5,110.4,8.489819,51.354567,-209,0.9715994020926756
8,2,26,5001,13,Eberbach,69412,81.15,14504,7030,7474,179,0.0,4.0,2454.1295360294826,109.5,8.989557,49.461538,-444,0.9405940594059405
8,1,17,5010,51,Uhingen,73066,24.79,14492,7139,7353,585,0.0,1.0,2743.402263880467,109.5,9.585162,48.70652,-214,0.9708962328301374
9,3,76,119,119,Burglengenfeld,93133,93.26,14484,7133,7351,155,0.0,2.0,3028.0,110.5,12.041577,49.2057,-218,0.9703441708611074
6,6,34,9,9,Homberg (Efze),34576,100.11,14458,7234,7224,144,0.0,1.0,1718.4172793215403,109.8,9.407119,51.032974,10,1.0013842746400885
5,5,70,36,36,Sassenberg,48336,78.08,14455,7326,7129,185,0.0,2.0,1951.439734253363,110.4,8.041446,51.988098,197,1.0276336092018516
9,2,77,116,116,Eggenfelden,84307,44.34,14437,7124,7313,326,0.0,2.0,2619.0,110.5,12.76246,48.403576,-189,0.9741556132913989
5,7,58,32,32,Spenge,32139,40.35,14416,7074,7342,357,0.0,2.0,1812.689734253363,110.4,8.48257,52.139046,-268,0.9634976845546173
8,2,16,5004,17,Gernsbach,76593,82.03,14397,7102,7295,176,0.0,1.0,2602.0,109.5,8.337715,48.763758,-193,0.9735435229609322
15,0,82,340,340,Sandersdorf-Brehna,6792,81.89,14375,6938,7437,176,0.0,2.0,1703.954749694436,110.7,12.212601,51.557318,-499,0.9329030523060374
8,4,35,5003,34,Markdorf,88677,40.91,14356,7117,7239,351,0.0,7.0,4011.5,109.5,9.389138,47.72035,-122,0.9831468434866695
14,6,26,5220,290,Löbau,2708,78.9,14352,6942,7410,182,0.0,2.0,1142.6013957730029,110.3,14.647805,51.074063,-468,0.9368421052631579
1,0,56,48,48,Tornesch,25436,20.61,14350,6998,7352,696,0.0,4.0,3240.0,109.4,9.711965,53.697658,-354,0.9518498367791077
14,5,22,5119,360,Mittweida,9648,41.26,14332,7126,7206,347,0.0,5.0,1565.0786679220182,110.3,13.0219,51.051083,-80,0.9888981404385234
9,3,75,174,174,Neutraubling,93073,9.75,14295,7095,7200,1466,0.0,2.0,3685.528072733723,110.5,12.200936,48.990294,-105,0.9854166666666667
6,5,33,3,3,Bad Camberg,65520,54.6,14294,6968,7326,262,0.0,1.0,2559.5,109.8,8.265932,50.29812,-358,0.9511329511329512
9,1,75,122,122,Grafing b.München,85567,29.58,14285,6999,7286,483,0.0,1.0,2767.2856486840537,110.5,11.966103,48.045389,-287,0.9606093878671425
6,5,31,11,11,Lich,35423,77.61,14218,6936,7282,183,0.0,4.0,2583.5,109.8,8.81911,50.519349,-346,0.9524855808843724
3,3,57,5408,57,Zeven,27404,74.13,14216,7159,7057,192,0.0,7.0,2119.798500580284,110.0,9.170931,53.302593,102,1.0144537338812527
14,7,30,230,230,Oschatz,4758,55.44,14195,6938,7257,256,0.0,3.0,1034.0,110.3,13.127338,51.386506,-319,0.95604244178035
5,1,54,24,24,Kalkar,47546,88.2,14191,7033,7158,161,0.0,1.0,1947.1973102036936,110.4,6.287776,51.737225,-125,0.9825370215143895
8,1,19,44,44,Murrhardt,71540,71.15,14180,7042,7138,199,0.0,1.0,2894.0,109.5,9.579648,48.980867,-96,0.9865508545811151
3,1,55,12,12,Uslar,37170,113.59,14174,7008,7166,125,0.0,2.0,2065.08638033193,110.0,9.635001,51.660912,-158,0.9779514373430086
14,6,28,60,60,Dippoldiswalde,1744,103.99,14161,6986,7175,136,0.0,1.0,1749.5,110.3,13.666852,50.896593,-189,0.9736585365853658
15,0,91,145,145,Jessen (Elster),6917,352.29,14158,7031,7127,40,0.0,1.0,1261.9623256447667,110.7,12.954825,51.790085,-96,0.9865300968149291
12,0,66,176,176,Lauchhammer,1979,89.3,14143,6945,7198,158,0.0,2.0,1210.0,110.7,13.762113,51.494487,-253,0.9648513475965546
9,2,79,122,122,Landau a.d.Isar,94405,84.4,14121,7074,7047,167,0.0,1.0,2513.0356486840537,110.5,12.691842,48.666545,27,1.003831417624521
12,0,68,468,468,Wittstock/Dosse,16909,420.23,14104,6959,7145,34,0.0,2.0,1415.954749694436,110.7,12.364917,53.145062,-186,0.9739678096571028
14,5,24,120,120,Hohenstein-Ernstthal,9337,18.58,14092,6778,7314,758,0.0,3.0,1838.3438198226722,110.3,12.637568,50.845071,-536,0.9267158873393492
6,6,32,18,18,Rotenburg a. d. Fulda,36199,79.97,14066,6894,7172,176,0.0,1.0,1458.0,109.8,9.724701,50.996422,-278,0.9612381483547128
7,3,32,24,24,Grünstadt,67269,18.09,14057,6892,7165,777,0.0,6.0,3031.8793995698943,109.8,8.162374,49.564892,-273,0.9618981158408932
15,0,88,205,205,Leuna,6237,87.85,14011,6992,7019,159,0.0,4.0,1716.439597793782,110.7,12.024179,51.323779,-27,0.9961532981906255
14,5,21,530,530,Schneeberg,8289,23.35,13994,7027,6967,599,0.0,2.0,1225.0,110.3,12.644409,50.594426,60,1.0086120281326252
1,0,57,91,91,Schwentinental,24223,17.81,13993,6723,7270,786,0.0,3.0,3070.2987734994385,109.4,10.238223,54.282411,-547,0.9247592847317744
6,4,31,16,16,Lorsch,64653,25.24,13989,6797,7192,554,0.0,6.0,3334.0,109.8,8.567793,49.653854,-395,0.9450778642936596
6,6,32,3,3,Bebra,36179,93.71,13983,6948,7035,149,0.0,1.0,1733.4172793215403,109.8,9.794171,50.970041,-87,0.9876332622601279
6,4,37,6,6,Erbach,64711,61.52,13977,6802,7175,227,0.0,2.0,3164.5,109.8,8.99268,49.657653,-373,0.9480139372822299
12,0,61,316,316,Lübben (Spreewald) / Lubin (Błota),15907,120.85,13966,6695,7271,116,0.0,2.0,1610.954749694436,110.7,13.896595,51.942032,-576,0.9207811855315637
9,7,75,162,162,Vöhringen,89269,23.69,13933,6833,7100,588,0.0,3.0,3163.0,110.5,10.076052,48.277272,-267,0.9623943661971831
9,5,72,135,135,Höchstadt a.d.Aisch,91315,70.87,13931,6936,6995,197,0.0,5.0,2535.7553448827384,110.5,10.805721,49.70285,-59,0.9915654038598999
6,5,31,6,6,Grünberg,35305,89.22,13930,6822,7108,156,0.0,2.0,1828.1597033712096,109.8,8.959065,50.592526,-286,0.9597636465953855
6,5,32,1,1,Aßlar,35614,43.57,13924,6845,7079,320,0.0,4.0,1948.0,109.8,8.464722,50.5893,-234,0.9669444836841362
9,7,75,164,164,Weißenhorn,89264,53.72,13913,6978,6935,259,0.0,2.0,2386.028072733723,110.5,10.160072,48.304461,43,1.00620043258832
6,6,34,14,14,Melsungen,34212,63.09,13906,6886,7020,220,0.0,1.0,2030.5,109.8,9.543745,51.131059,-134,0.9809116809116809
9,7,77,5748,121,Buchloe,86807,36.18,13904,6901,7003,384,0.0,2.0,2376.028072733723,110.5,10.723757,48.035957,-102,0.9854348136512923
14,5,24,5118,190,Meerane,8393,19.81,13888,6721,7167,701,0.0,3.0,1027.5,110.3,12.460898,50.815499,-446,0.9377703362634296
3,4,59,5401,30,Quakenbrück,49610,17.96,13884,6832,7052,773,0.0,4.0,2733.321228431276,110.0,7.956372,52.675863,-220,0.968803176403857
8,2,15,5006,66,Philippsburg,76661,50.54,13882,7073,6809,275,0.0,2.0,2788.0,109.5,8.453544,49.236173,264,1.0387722132471728
6,5,35,11,11,Lauterbach (Hessen),36341,101.98,13880,6741,7139,136,0.0,1.0,1799.9172793215403,109.8,9.397967,50.635729,-398,0.9442498949432694
8,3,17,5002,26,Ettenheim,77955,48.8,13871,6856,7015,284,0.0,2.0,3045.5,109.5,7.812984,48.254555,-159,0.9773342836778333
9,5,76,127,127,Hilpoltstein,91161,89.72,13868,7018,6850,155,0.0,4.0,2447.762920833069,110.5,11.188846,49.190711,168,1.0245255474452555
6,5,32,21,21,Solms,35606,34.02,13862,6893,6969,407,0.0,1.0,1826.0,109.8,8.405659,50.538809,-76,0.989094561630076
6,4,35,2,2,Bad Soden-Salmünster,63628,58.59,13823,6841,6982,236,0.0,3.0,2328.902127420879,109.8,9.372421,50.275248,-141,0.9798052134059009
9,6,74,147,147,Haßfurt,97437,52.66,13818,6826,6992,262,0.0,4.0,2606.262920833069,110.5,10.506648,50.031494,-166,0.976258581235698
15,0,83,531,531,Wanzleben-Börde,39164,188.15,13813,6886,6927,73,0.0,1.0,1206.5,110.7,11.445377,52.060628,-41,0.9940811318030893
9,7,74,150,150,Krumbach (Schwaben),86381,44.64,13807,6776,7031,309,0.0,2.0,2406.278072733723,110.5,10.360594,48.242164,-255,0.963732043806002
3,4,53,11,11,Löningen,49624,143.52,13796,6908,6888,96,0.0,2.0,1724.5,110.0,7.757443,52.735274,20,1.0029036004645762
6,4,36,2,2,Eppstein,65817,24.19,13758,6691,7067,569,0.0,2.0,2637.9097033712096,109.8,8.396967,50.140666,-376,0.9467949625017688
8,1,15,5004,24,Holzgerlingen,71088,13.39,13750,6718,7032,1027,0.0,5.0,4282.5,109.5,9.011719,48.637131,-314,0.9553469852104665
14,5,22,150,150,Frankenberg/Sa.,9669,65.62,13750,6776,6974,210,0.0,4.0,1365.0862438723489,110.3,13.030777,50.910034,-198,0.9716088328075709
9,1,76,123,123,Eichstätt,85072,47.79,13714,6640,7074,287,0.0,3.0,2685.5204967833924,110.5,11.185203,48.891094,-434,0.9386485722363584
6,5,34,4,4,Biedenkopf,35216,90.31,13703,6823,6880,152,0.0,3.0,1507.0,109.8,8.531086,50.910424,-57,0.9917151162790697
12,0,73,8,8,Angermünde,16278,324.23,13692,6567,7125,42,0.0,1.0,1258.4623256447667,110.7,14.003142,53.017304,-558,0.9216842105263158
13,0,73,5353,10,Bergen auf Rügen,18528,51.49,13689,6577,7112,266,0.0,2.0,2281.0,111.0,13.430633,54.417301,-535,0.9247750281214848
15,0,86,40,40,Genthin,39307,230.87,13685,6741,6944,59,0.0,2.0,1683.704749694436,110.7,12.154669,52.405987,-203,0.9707661290322581
16,0,77,5052,43,Schmölln,4626,94.53,13684,6742,6942,145,0.0,5.0,1123.0,110.9,12.319799,50.947653,-200,0.9711898588303083
15,0,87,220,220,Hettstedt,6333,36.93,13678,6691,6987,370,0.0,1.0,1816.7123256447667,110.7,11.51366,51.645013,-296,0.9576356089881208
5,5,70,40,40,Sendenhorst,48324,96.95,13671,6743,6928,141,0.0,6.0,2540.0,110.4,7.82746,51.84466,-185,0.973296766743649
8,3,26,3,3,Bad Dürrheim,78073,62.08,13659,6581,7078,220,0.0,4.0,2642.3795360294826,109.5,8.530554,48.022026,-497,0.9297824244136762
8,4,37,5004,88,Pfullendorf,88630,90.5,13616,6714,6902,150,0.0,3.0,2451.5,109.5,9.255547,47.923774,-188,0.9727615184004637
6,5,31,12,12,Linden,35440,22.77,13583,6773,6810,597,0.0,3.0,2299.902127420879,109.8,8.652659,50.530078,-37,0.9945668135095448
8,2,26,5005,56,Neckargemünd,69151,26.16,13576,6613,6963,519,0.0,3.0,2761.637111979806,109.5,8.7973,49.394478,-350,0.9497343099238834
15,0,83,411,411,Oebisfelde-Weferlingen,39646,249.36,13566,6834,6732,54,0.0,1.0,1381.0,110.7,10.986962,52.435124,102,1.0151515151515151
9,4,72,175,175,Pegnitz,91257,99.98,13561,6730,6831,136,0.0,2.0,2387.778072733723,110.5,11.544194,49.756304,-101,0.985214463475333
8,1,18,3,3,Asperg,71679,5.8,13559,6715,6844,2338,0.0,3.0,4628.0,109.5,9.135236,48.905309,-129,0.9811513734658095
3,4,54,19,19,Haselünne,49740,159.43,13552,6672,6880,85,0.0,1.0,1950.8439562822605,110.0,7.486718,52.67361,-208,0.9697674418604652
3,3,51,4,4,Bergen,29303,164.39,13532,6664,6868,82,0.0,5.0,1474.0,110.0,9.962303,52.809523,-204,0.9702970297029703
8,3,27,5004,46,Spaichingen,78549,18.5,13531,6764,6767,731,0.0,4.0,3036.3795360294826,109.5,8.739277,48.073153,-3,0.999556672085119
9,2,77,138,138,Pfarrkirchen,84347,52.35,13522,6680,6842,258,0.0,2.0,2563.5,110.5,12.937787,48.432193,-162,0.9763227126571178
3,2,54,5,5,Bad Salzdetfurth,31162,67.18,13520,6619,6901,201,0.0,1.0,2011.0939562822605,110.0,10.007627,52.063403,-282,0.9591363570497029
8,1,28,5004,115,Tauberbischofsheim,97941,69.29,13513,6707,6806,195,0.0,2.0,2365.0,109.5,9.662778,49.622047,-99,0.9854540111666177
3,4,52,25,25,Wiesmoor,26639,82.94,13502,6524,6978,163,0.0,4.0,1974.3212284312758,110.0,7.739544,53.417153,-454,0.9349383777586701
6,6,33,28,28,Wolfhagen,34466,112.29,13493,6722,6771,120,0.0,2.0,1414.0,109.8,9.169659,51.326016,-49,0.9927632550583371
5,9,70,28,28,Bad Laasphe,57334,135.95,13467,6778,6689,99,0.0,2.0,1754.189734253363,110.4,8.41223,50.927285,89,1.0133054268201525
9,5,75,153,153,Neustadt a.d.Aisch,91413,61.21,13419,6532,6887,219,0.0,4.0,2561.262920833069,110.5,10.612689,49.579782,-355,0.9484536082474226
3,4,60,3,3,Dinklage,49413,72.81,13410,6682,6728,184,0.0,1.0,2134.0,110.0,8.123768,52.661041,-46,0.9931629013079667
6,5,33,17,17,Weilburg,35781,57.51,13334,6681,6653,232,0.0,1.0,1882.1672793215403,109.8,8.263871,50.484433,28,1.004208627686758
5,5,54,64,64,Velen,46342,70.75,13304,6683,6621,188,0.0,2.0,1926.5,110.4,6.986506,51.894372,62,1.009364144389065
8,1,25,5014,102,Weinsberg,74189,22.22,13290,6673,6617,598,0.0,1.0,2836.152263880467,109.5,9.285758,49.150258,56,1.008463049720417
12,0,65,356,356,Zehdenick,16792,223.06,13283,6617,6666,60,0.0,2.0,2186.5,110.7,13.332283,52.979224,-49,0.9926492649264926
3,4,56,5403,27,Schüttorf,48465,19.45,13273,6661,6612,682,0.0,4.0,2608.071228431276,110.0,7.175182,52.391482,49,1.0074107683000606
3,2,51,40,40,Sulingen,27232,110.83,13268,6566,6702,120,0.0,1.0,1663.5,110.0,8.801224,52.682116,-136,0.979707549985079
5,5,58,36,36,Olfen,59399,52.43,13253,6369,6884,253,0.0,3.0,2502.5,110.4,7.38,51.708879,-515,0.9251888436955259
1,0,55,46,46,Fehmarn,23769,185.5,13247,6431,6816,71,0.0,3.0,2271.5487734994385,109.4,11.197614,54.4387,-385,0.9435152582159625
8,1,35,20,20,Herbrechtingen,89542,58.63,13247,6516,6731,226,0.0,3.0,2498.5,109.5,10.175775,48.621668,-215,0.9680582380032685
8,2,15,64,64,Östringen,76684,53.28,13241,6767,6474,249,0.0,3.0,2579.637111979806,109.5,8.712417,49.218783,293,1.045257954896509
5,7,62,8,8,Beverungen,37688,98.09,13238,6541,6697,135,0.0,2.0,1643.189734253363,110.4,9.372651,51.662804,-156,0.9767059877557115
12,0,69,17,17,Beelitz,14547,181.3,13219,6596,6623,73,0.0,1.0,2980.0,110.7,12.977691,52.232322,-27,0.9959232975992752
8,3,26,52,52,St. Georgen im Schwarzwald,78112,59.85,13122,6463,6659,219,0.0,2.0,2563.3946879301366,109.5,8.332259,48.126225,-196,0.9705661510737348
9,2,71,146,146,Plattling,94447,35.9,13121,6578,6543,365,0.0,2.0,2606.5,110.5,12.873601,48.776597,35,1.0053492281827907
8,3,37,116,116,Wehr,79664,35.64,13113,6419,6694,368,0.0,1.0,2790.402263880467,109.5,7.904562,47.629747,-275,0.9589184344188826
9,5,77,173,173,Treuchtlingen,91757,103.38,13112,6666,6446,127,0.0,2.0,2349.5,110.5,10.905634,48.9582,220,1.0341296928327646
6,4,40,23,23,Rosbach v. d. Höhe,61191,45.33,13110,6455,6655,289,0.0,5.0,2498.386975520225,109.8,8.692481,50.304532,-200,0.9699474079639369
9,1,71,111,111,Altötting,84503,23.07,13104,6221,6883,568,0.0,3.0,3034.0,110.5,12.67892,48.227986,-662,0.9038210082812727
15,0,82,377,377,Südliches Anhalt,6369,192.63,13081,6568,6513,68,0.0,2.0,1510.954749694436,110.7,12.072808,51.672095,55,1.008444649163212
6,5,31,8,8,Hungen,35410,86.78,13073,6427,6646,151,0.0,1.0,1892.0,109.8,8.901404,50.475592,-219,0.9670478483298225
6,5,33,7,7,Hadamar,65589,40.99,13042,6658,6384,318,0.0,4.0,2407.3945514705556,109.8,8.045892,50.44863,274,1.042919799498747
9,4,73,159,159,Rödental,96472,49.97,13033,6413,6620,261,0.0,3.0,2640.7704967833924,110.5,11.032458,50.290191,-207,0.9687311178247734
5,3,58,36,36,Linnich,52441,65.43,13015,6440,6575,199,0.0,2.0,1910.0,110.4,6.267275,50.978896,-135,0.979467680608365
9,1,87,182,182,Wasserburg a.Inn,83512,18.8,13004,6531,6473,692,0.0,1.0,3027.7856486840537,110.5,12.232253,48.060937,58,1.0089602966167155
5,3,66,36,36,Schleiden,53937,121.67,12977,6500,6477,107,0.0,3.0,2025.4321583030323,110.4,6.476481,50.529592,23,1.0035510267098966
9,3,72,153,153,Roding,93426,119.61,12972,6622,6350,108,0.0,2.0,2127.0,110.5,12.51827,49.193203,272,1.0428346456692914
13,0,72,6,6,Bad Doberan,18209,32.85,12954,6138,6816,394,0.0,4.0,1785.7046132348623,111.0,11.89935,54.106684,-678,0.9005281690140845
6,4,35,29,29,Wächtersbach,63607,50.79,12948,6432,6516,255,0.0,1.0,2266.0,109.8,9.292299,50.257679,-84,0.9871086556169429
15,0,86,140,140,Möckern,39291,524.85,12918,6533,6385,25,0.0,2.0,1453.704749694436,110.7,11.952694,52.139752,148,1.0231793265465936
8,1,18,5001,7,Besigheim,74354,16.83,12909,6463,6446,767,0.0,3.0,3799.0,109.5,9.140825,49.000174,17,1.0026372944461681
3,1,59,19,19,Herzberg am Harz,37412,71.88,12829,6314,6515,178,0.0,2.0,2179.83638033193,110.0,10.340023,51.65664,-201,0.9691481197237145
8,4,15,5005,78,Bad Urach,72574,55.42,12812,6352,6460,231,0.0,1.0,2276.652263880467,109.5,9.400021,48.493051,-108,0.98328173374613
3,2,51,42,42,Twistringen,27239,114.38,12779,6417,6362,112,0.0,2.0,1677.0,110.0,8.63877,52.799962,55,1.0086450801634705
8,3,25,5006,57,Sulz am Neckar,72172,87.62,12724,6351,6373,145,0.0,2.0,2311.8946879301366,109.5,8.632773,48.366375,-22,0.9965479366075631
9,5,71,145,145,Feuchtwangen,91555,137.21,12683,6372,6311,92,0.0,1.0,2204.2856486840537,110.5,10.331415,49.167757,61,1.009665663127872
9,5,74,132,132,Hersbruck,91217,22.9,12681,6182,6499,554,0.0,3.0,2846.5,110.5,11.429693,49.507981,-317,0.9512232651177104
5,9,58,48,48,Winterberg,59955,147.95,12671,6344,6327,86,0.0,3.0,1743.1821583030323,110.4,8.533102,51.194349,17,1.0026868974237395
8,4,25,5002,20,Blaubeuren,89143,79.11,12665,6384,6281,160,0.0,5.0,2815.0,109.5,9.783757,48.412587,103,1.0163986626333386
8,1,18,5002,71,Tamm,71732,8.78,12658,6340,6318,1442,0.0,1.0,3486.402263880467,109.5,9.117204,48.920183,22,1.0034821145932258
16,0,67,72,72,Waltershausen,99880,60.62,12650,6234,6416,209,0.0,5.0,1385.5,110.9,10.559244,50.900529,-182,0.9716334164588528
9,1,90,148,148,Schongau,86956,21.34,12648,6221,6427,593,0.0,1.0,2992.2856486840537,110.5,10.894702,47.815235,-206,0.9679477205539132
9,5,75,112,112,Bad Windsheim,91438,78.24,12643,6159,6484,162,0.0,4.0,2476.512920833069,110.5,10.4192,49.502758,-325,0.9498766193707588
5,7,62,32,32,Steinheim,32839,75.69,12612,6189,6423,167,0.0,2.0,1450.0,110.4,9.096625,51.866755,-234,0.9635684259691732
12,0,72,169,169,Jüterbog,14913,176.48,12612,6099,6513,71,0.0,2.0,1505.204749694436,110.7,13.081594,51.99201,-414,0.9364348226623675
1,0,51,11,11,Brunsbüttel,25541,65.21,12603,6321,6282,193,0.0,2.0,1931.5,109.4,9.13735,53.896932,39,1.0062082139446036
6,6,36,6,6,Hessisch Lichtenau,37235,105.72,12598,6355,6243,119,0.0,2.0,1774.6597033712096,109.8,9.720907,51.198577,112,1.0179400929040525
9,2,74,184,184,Vilsbiburg,84137,68.84,12584,6301,6283,183,0.0,2.0,3185.0,110.5,12.357548,48.451397,18,1.0028648734680885
6,6,34,1,1,Borken (Hessen),34582,82.46,12555,6303,6252,152,0.0,2.0,1780.9097033712096,109.8,9.287087,51.046041,51,1.0081573896353166
9,5,74,152,152,Röthenbach a.d.Pegnitz,90552,14.29,12531,6033,6498,877,0.0,2.0,3062.278072733723,110.5,11.238754,49.482066,-465,0.9284395198522623
5,7,70,36,36,Preußisch Oldendorf,32361,68.76,12531,6177,6354,182,0.0,1.0,1653.0,110.4,8.495612,52.306051,-177,0.9721435316336167
8,2,26,38,38,Ladenburg,68526,19.0,12517,6029,6488,659,0.0,1.0,2875.902263880467,109.5,8.610298,49.471947,-459,0.9292540073982737
16,0,66,92,92,Zella-Mehlis,98544,52.99,12514,6146,6368,236,0.0,2.0,1309.5,110.9,10.658023,50.663357,-222,0.9651381909547738
6,5,34,10,10,Gladenbach,35075,72.28,12513,6256,6257,173,0.0,1.0,1817.4172793215403,109.8,8.581836,50.769827,-1,0.9998401789995205
8,3,15,76,76,Neuenburg am Rhein,79395,44.1,12482,6200,6282,283,0.0,2.0,2580.6446879301366,109.5,7.559796,47.813974,-82,0.9869468322190386
12,0,65,332,332,Velten,16727,23.42,12424,6137,6287,530,0.0,1.0,3108.0,110.7,13.111985,52.696092,-150,0.976141243836488
8,1,27,5006,25,Gaildorf,74405,62.59,12408,6126,6282,198,0.0,1.0,2444.902263880467,109.5,9.76983,49.00045,-156,0.9751671442215855
13,0,76,60,60,Hagenow,19230,67.54,12399,6160,6239,184,0.0,1.0,1627.5,111.0,11.192521,53.432045,-79,0.9873377143773041
8,3,15,5017,113,Titisee-Neustadt,79822,89.64,12390,6080,6310,138,0.0,2.0,2360.8946879301366,109.5,8.208431,47.916511,-230,0.9635499207606973
9,1,75,115,115,Ebersberg,85560,40.84,12386,6032,6354,303,0.0,3.0,5653.0,110.5,11.968817,48.078429,-322,0.9493232609379918
12,0,64,44,44,Bad Freienwalde (Oder),16259,131.11,12360,6050,6310,94,0.0,1.0,1404.9623256447667,110.7,14.031047,52.788194,-260,0.9587955625990491
5,7,74,40,40,Bad Wünnenberg,33181,161.3,12341,6160,6181,77,0.0,5.0,1654.5,110.4,8.697601,51.517257,-21,0.9966024915062288
3,3,58,8,8,Bad Fallingbostel,29683,64.02,12340,6178,6162,193,0.0,3.0,2053.828804381599,110.0,9.693984,52.865924,16,1.0025965595585848
13,0,75,5,5,Anklam,17389,56.68,12312,5779,6533,217,0.0,1.0,1315.0,111.0,13.693003,53.855297,-754,0.8845859482626665
8,1,16,72,72,Wernau (Neckar),73249,10.89,12306,6063,6243,1130,0.0,3.0,3412.387111979806,109.5,9.421663,48.689366,-180,0.9711677078327727
14,7,29,140,140,Frohburg,4654,145.29,12305,6074,6231,85,0.0,3.0,1211.5,110.3,12.556473,51.057446,-157,0.9748034023431231
8,4,17,13,13,Burladingen,72393,123.31,12273,6092,6181,100,0.0,2.0,2222.1446879301366,109.5,9.1153,48.28913,-89,0.98560103543116
13,0,76,90,90,Ludwigslust,19288,78.64,12270,5881,6389,156,0.0,4.0,1617.9546132348623,111.0,11.497142,53.326305,-508,0.9204883393332289
9,5,71,136,136,Dinkelsbühl,91550,75.16,12267,5995,6272,163,0.0,2.0,2808.5,110.5,10.320207,49.068879,-277,0.9558354591836735
8,4,25,5007,71,Laichingen,89150,69.83,12250,6251,5999,175,0.0,1.0,2437.152263880467,109.5,9.685733,48.489445,252,1.0420070011668612
8,1,18,5007,70,Steinheim an der Murr,71711,23.18,12228,6077,6151,528,0.0,2.0,3900.5,109.5,9.259995,48.962627,-74,0.9879694358640871
9,3,76,141,141,Maxhütte-Haidhof,93142,34.69,12225,6108,6117,352,0.0,3.0,2740.5204967833924,110.5,12.093321,49.20199,-9,0.9985286905345758
9,2,71,141,141,Osterhofen,94486,111.16,12171,6060,6111,109,0.0,1.0,2405.5356486840537,110.5,13.022845,48.699902,-51,0.9916543937162494
12,0,70,296,296,Perleberg,19348,138.69,12108,5923,6185,87,0.0,4.0,1315.5,110.7,11.864297,53.076035,-262,0.9576394502829426
9,1,82,125,125,Miesbach,83714,32.44,12083,5888,6195,372,0.0,1.0,2699.7856486840537,110.5,11.834173,47.788844,-307,0.9504439063761098
13,0,75,5551,144,Wolgast,17438,61.73,12055,5867,6188,195,0.0,2.0,1467.4697651355164,111.0,13.774621,54.052886,-321,0.9481254040077569
12,0,67,124,124,Erkner,15537,16.53,11970,5645,6325,724,0.0,2.0,3128.5,110.7,13.754248,52.4197,-680,0.892490118577075
14,6,28,260,260,Neustadt in Sachsen,1844,83.12,11888,5710,6178,143,0.0,1.0,1140.3589717233335,110.3,14.214891,51.025462,-468,0.9242473292327614
5,3,34,20,20,Monschau,52156,94.6,11864,5813,6051,125,0.0,2.0,2140.0,110.4,6.239288,50.555279,-238,0.9606676582383077
1,0,53,83,83,Lauenburg/ Elbe,21481,9.56,11855,5903,5952,1240,0.0,2.0,3339.806349449769,109.4,10.554267,53.374189,-49,0.9917674731182796
8,2,26,5003,31,Hemsbach,69502,12.85,11828,5753,6075,920,0.0,1.0,3015.402263880467,109.5,8.656453,49.592797,-322,0.9469958847736626
6,4,39,12,12,Oestrich-Winkel,65375,59.51,11823,5729,6094,199,0.0,3.0,3431.0,109.8,8.00726,49.998444,-365,0.9401050213324581
8,1,25,5006,56,Lauffen am Neckar,74348,22.63,11816,5872,5944,522,0.0,3.0,2846.887111979806,109.5,9.150312,49.076213,-72,0.9878869448183042
8,1,25,58,58,Leingarten,74211,23.47,11816,5867,5949,503,0.0,2.0,2874.6446879301366,109.5,9.127562,49.143857,-82,0.9862161707850059
8,2,25,5001,109,Walldürn,74731,105.91,11813,6015,5798,112,0.0,2.0,1833.0,109.5,9.368531,49.582516,217,1.0374266988616765
5,9,62,48,48,Neuenrade,58809,54.1,11793,5826,5967,218,0.0,2.0,1908.689734253363,110.4,7.77967,51.281925,-141,0.9763700351935646
14,5,21,5140,710,Zwönitz,8297,64.24,11786,5727,6059,183,0.0,2.0,1449.6013957730029,110.3,12.811053,50.630002,-332,0.9452054794520548
9,2,75,126,126,Hauzenberg,94051,82.79,11781,5842,5939,142,0.0,1.0,1851.5,110.5,13.625401,48.65453,-97,0.9836672840545546
12,0,70,316,316,Pritzwalk,16928,167.32,11777,5765,6012,70,0.0,5.0,1727.4320218434514,110.7,12.055363,53.118372,-247,0.958915502328676
5,9,66,8,8,Drolshagen,57489,67.11,11763,5902,5861,175,0.0,6.0,1898.0,110.4,7.775835,51.024727,41,1.0069953932775977
8,1,36,5002,10,Bopfingen,73441,76.96,11755,5811,5944,153,0.0,2.0,2480.3946879301366,109.5,10.351593,48.857911,-133,0.9776244952893675
16,0,75,85,85,Pößneck,7381,24.43,11752,5631,6121,481,0.0,3.0,1771.3738507048256,110.9,11.591589,50.695668,-490,0.9199477209606274
15,0,88,20,20,Bad Dürrenberg,6231,36.15,11752,5744,6008,325,0.0,3.0,1534.5,110.7,12.068592,51.292022,-264,0.9560585885486018
9,7,76,117,117,Lindenberg i.Allgäu,88161,11.84,11739,5780,5959,991,0.0,1.0,2985.7856486840537,110.5,9.885042,47.602267,-179,0.969961402919953
6,4,39,4,4,Geisenheim,65366,40.34,11699,5757,5942,290,0.0,2.0,2393.4097033712096,109.8,7.965681,49.983339,-185,0.9688657017839112
16,0,69,24,24,Hildburghausen,98646,72.89,11689,5802,5887,160,0.0,2.0,1530.5,110.9,10.729007,50.425612,-85,0.9855614064888738
8,1,25,5013,86,Schwaigern,74193,49.49,11687,5857,5830,236,0.0,2.0,2543.3946879301366,109.5,9.056965,49.141683,27,1.004631217838765
5,5,58,8,8,Billerbeck,48727,91.36,11681,5788,5893,128,0.0,1.0,1773.6973102036936,110.4,7.290998,51.977524,-105,0.9821822501272697
9,1,86,5156,122,Geisenfeld,85290,88.3,11605,6033,5572,131,0.0,3.0,3729.5,110.5,11.612053,48.684143,461,1.082735104091888
15,0,83,565,565,Wolmirstedt,39326,54.27,11602,5571,6031,214,0.0,2.0,2228.454749694436,110.7,11.521853,52.23455,-460,0.9237274083899851
8,4,17,5005,44,Meßstetten,72469,76.8,11560,5858,5702,151,0.0,3.0,1996.0,109.5,8.963167,48.180979,156,1.0273588214661522
3,1,51,40,40,Wittingen,29378,225.83,11489,5783,5706,51,0.0,2.0,1807.5863803319298,110.0,10.740212,52.72877,77,1.0134945671223274
15,0,91,60,60,Coswig (Anhalt),6869,295.71,11488,5767,5721,39,0.0,3.0,1348.9471737441054,110.7,12.457663,51.885582,46,1.0080405523509877
15,0,91,110,110,Gräfenhainichen,6773,159.55,11446,5541,5905,72,0.0,3.0,1532.1971737441054,110.7,12.455564,51.72918,-364,0.9383573243014395
9,1,89,157,157,Trostberg,83308,51.55,11444,5583,5861,222,0.0,3.0,3125.5,110.5,12.557057,48.027285,-278,0.9525678211909231
14,6,26,85,85,Ebersbach-Neugersdorf,2730,20.45,11441,5494,5947,559,0.0,2.0,1498.6013957730029,110.3,14.582746,51.009334,-453,0.9238271397343198
6,4,39,2,2,Bad Schwalbach,65307,40.27,11430,5627,5803,284,0.0,5.0,2524.136975520225,109.8,8.069825,50.140276,-176,0.9696708599000518
9,6,77,157,157,Marktheidenfeld,97828,35.7,11388,5510,5878,319,0.0,1.0,2571.5,110.5,9.600307,49.844144,-368,0.9373936713167744
8,3,35,5001,22,Engen,78234,70.56,11355,5637,5718,161,0.0,1.0,2407.902263880467,109.5,8.772115,47.854017,-81,0.9858342077649528
9,5,71,193,193,Rothenburg ob der Tauber,91541,41.67,11347,5461,5886,272,0.0,3.0,2577.7704967833924,110.5,10.179283,49.377149,-425,0.9277947672443085
9,6,79,170,170,Ochsenfurt,97199,63.57,11346,5629,5717,178,0.0,2.0,2413.0,110.5,10.060849,49.665427,-88,0.9846073115270246
8,3,17,153,153,Rheinau,77866,73.5,11343,5723,5620,154,0.0,2.0,2474.8946879301366,109.5,7.939856,48.664363,103,1.0183274021352313
8,1,19,5005,84,Welzheim,73642,37.99,11335,5553,5782,298,0.0,1.0,2526.402263880467,109.5,9.63467,48.874336,-229,0.9603943272224144
7,1,37,5008,216,Mülheim-Kärlich,56218,16.42,11312,5578,5734,689,0.0,1.0,2431.0,109.8,7.497417,50.38682,-156,0.9727938611789326
3,2,57,5403,6,Bad Nenndorf,31542,23.22,11289,5389,5900,486,0.0,1.0,2229.5939562822605,110.0,9.374996,52.339433,-511,0.9133898305084746
9,7,73,144,144,Lauingen (Donau),89415,44.39,11229,5636,5593,253,0.0,1.0,2462.5,110.5,10.429935,48.570341,43,1.007688181655641
5,7,54,52,52,Werther (Westf.),33824,35.42,11229,5515,5714,317,0.0,3.0,1829.6821583030323,110.4,8.411163,52.072545,-199,0.9651732586629331
8,3,16,5004,17,Herbolzheim,79336,35.48,11224,5619,5605,316,0.0,1.0,3244.0,109.5,7.777447,48.222221,14,1.0024977698483497
7,1,41,5003,29,Diez,65582,12.41,11211,5753,5458,903,0.0,1.0,2929.1672793215403,109.8,8.001978,50.385738,295,1.054049102235251
3,1,54,19,19,Schöningen,38364,35.47,11209,5473,5736,316,0.0,1.0,2263.8439562822605,110.0,10.967701,52.141775,-263,0.9541492329149233
5,5,54,32,32,Isselburg,46419,42.8,11208,5630,5578,262,0.0,4.0,1968.5,110.4,6.46301,51.833522,52,1.0093223377554679
12,0,69,20,20,Bad Belzig,14806,236.09,11172,5451,5721,47,0.0,1.0,1286.2123256447667,110.7,12.586743,52.140642,-270,0.9528054535920294
5,9,62,8,8,Balve,58802,74.81,11143,5541,5602,149,0.0,1.0,1762.4473102036936,110.4,7.864187,51.330545,-61,0.9891110317743663
9,2,72,151,151,Waldkirchen,94065,80.01,11143,5501,5642,139,0.0,2.0,1934.0,110.5,13.599855,48.730908,-141,0.9750088621056363
14,5,21,5133,590,Stollberg/Erzgeb.,9366,38.99,11139,5328,5811,286,0.0,2.0,1513.3513957730029,110.3,12.786017,50.726686,-483,0.9168817759421787
6,5,32,3,3,Braunfels,35619,47.28,11131,5341,5790,235,0.0,3.0,1994.402127420879,109.8,8.38959,50.514702,-449,0.9224525043177892
8,3,17,5003,34,Gengenbach,77723,61.9,11116,5408,5708,180,0.0,2.0,3244.0,109.5,8.013343,48.405617,-300,0.9474421864050455
8,1,15,42,42,Rutesheim,71277,16.22,11056,5469,5587,682,0.0,2.0,2932.1446879301366,109.5,8.945152,48.809882,-118,0.978879541793449
8,4,26,5007,97,Riedlingen,88499,64.96,11029,5606,5423,170,0.0,1.0,2455.152263880467,109.5,9.517274,48.234296,183,1.0337451595058087
6,4,33,4,4,Gernsheim,64579,40.11,11024,5464,5560,275,0.0,2.0,3097.0,109.8,8.493249,49.752294,-96,0.9827338129496402
9,2,76,138,138,Regen,94209,65.14,11005,5481,5524,169,0.0,2.0,2568.778072733723,110.5,13.126196,48.970244,-43,0.9922157856625634
8,1,36,42,42,Lorch,73547,34.28,11003,5550,5453,321,0.0,2.0,1874.5,109.5,9.689403,48.797029,97,1.0177883733724555
12,0,61,540,540,Wildau,15745,9.11,10984,5458,5526,1206,0.0,4.0,2823.439597793782,110.7,13.636571,52.321356,-68,0.9876945349258053
8,4,17,25,25,Haigerloch,72401,76.44,10968,5456,5512,143,0.0,1.0,2016.5,109.5,8.804191,48.366535,-56,0.9898403483309144
5,9,74,36,36,Rüthen,59602,158.15,10957,5625,5332,69,0.0,4.0,1848.924582352709,110.4,8.431127,51.491486,293,1.0549512378094523
16,0,74,5052,18,Eisenberg,7607,24.67,10957,5326,5631,444,0.0,2.0,1208.5,110.9,11.901344,50.967554,-305,0.9458355531877108
14,5,24,5128,160,Lichtenstein/Sa.,9350,15.47,10946,5232,5714,708,0.0,1.0,1635.6089717233335,110.3,12.630844,50.756298,-482,0.9156457822891144
8,1,17,5006,15,Donzdorf,73072,39.82,10927,5501,5426,274,0.0,2.0,2479.6446879301366,109.5,9.811046,48.686613,75,1.0138223368964245
8,2,35,5001,6,Altensteig,72213,53.19,10916,5570,5346,205,0.0,2.0,2327.0,109.5,8.601974,48.584389,224,1.0419004863449308
8,3,16,5004,20,Kenzingen,79341,36.93,10908,5379,5529,295,0.0,1.0,2440.402263880467,109.5,7.769903,48.193031,-150,0.9728703201302225
15,0,85,230,230,Osterwieck,38835,212.91,10898,5531,5367,51,0.0,1.0,1258.0,110.7,10.706798,51.972545,164,1.0305571082541458
9,5,73,120,120,Langenzenn,90579,46.33,10887,5268,5619,235,0.0,2.0,2457.278072733723,110.5,10.794782,49.493317,-351,0.9375333689268553
1,0,61,29,29,Glückstadt,25348,22.75,10885,5279,5606,478,0.0,2.0,2753.056349449769,109.4,9.423724,53.787808,-327,0.9416696396717802
9,6,72,127,127,Hammelburg,97762,128.88,10883,5403,5480,84,0.0,1.0,1943.0,110.5,9.89097,50.115381,-77,0.9859489051094891
5,7,74,28,28,Lichtenau,33165,192.57,10867,5574,5293,56,0.0,1.0,1475.1973102036936,110.4,8.895788,51.616847,281,1.0530889854524843
6,4,34,10,10,Steinbach (Taunus),61449,4.4,10846,5249,5597,2465,0.0,3.0,4703.0,109.8,8.5721,50.167692,-348,0.9378238341968912
14,5,21,450,450,Oelsnitz/Erzgeb.,9376,26.28,10837,5258,5579,412,0.0,2.0,1634.1013957730029,110.3,12.706087,50.724284,-321,0.9424628069546513
3,2,54,5406,43,Gronau (Leine),31028,88.39,10832,5322,5510,123,0.0,1.0,2226.0,110.0,9.774244,52.084178,-188,0.9658802177858439
13,0,76,14,14,Boizenburg/ Elbe,19258,47.42,10829,5367,5462,228,0.0,5.0,1692.1970372845317,111.0,10.722631,53.374248,-95,0.9826071036250458
6,4,35,1,1,Bad Orb,63619,47.75,10725,5129,5596,225,0.0,1.0,2274.5,109.8,9.348206,50.227786,-467,0.9165475339528234
14,6,25,5207,40,Bischofswerda,1877,46.21,10686,5088,5598,231,0.0,4.0,1157.8362438723489,110.3,14.247616,51.144952,-510,0.9088960342979635
9,4,78,165,165,Bad Staffelstein,96231,99.51,10683,5200,5483,107,0.0,1.0,2437.5,110.5,10.999853,50.10147,-283,0.9483859201167244
3,4,59,15,15,Dissen am Teutoburger Wald,49201,31.9,10638,5374,5264,333,0.0,2.0,2324.58638033193,110.0,8.201339,52.114735,110,1.0208966565349544
6,6,34,3,3,Felsberg,34587,83.32,10633,5265,5368,128,0.0,2.0,1526.5,109.8,9.422077,51.134766,-103,0.9808122205663189
1,0,56,2,2,Barmstedt,25355,17.17,10630,5204,5426,619,0.0,3.0,2873.2987734994385,109.4,9.768595,53.790385,-222,0.9590858827865831
16,0,69,43,43,Schleusingen,98553,125.59,10620,5233,5387,85,0.0,1.0,1345.5,110.9,10.749262,50.509068,-154,0.9714126601076666
15,0,90,546,546,Tangerhütte,39517,295.17,10599,5269,5330,36,0.0,3.0,1946.9471737441054,110.7,11.697357,52.407425,-61,0.9885553470919325
3,4,56,5402,14,Neuenhaus,49828,31.37,10561,5289,5272,337,0.0,6.0,2405.0560765306145,110.0,6.959226,52.541454,17,1.0032245827010622
3,4,59,4,4,Bad Iburg,49186,36.47,10559,5095,5464,290,0.0,1.0,2168.0,110.0,8.045253,52.156471,-369,0.9324670571010248
1,0,58,34,34,Büdelsdorf,24782,6.48,10546,5013,5533,1627,0.0,3.0,3786.7987734994385,109.4,9.677817,54.315687,-520,0.9060184348454726
3,4,54,5409,57,Werlte,49757,63.81,10539,5410,5129,165,0.0,2.0,2043.8363803319298,110.0,7.616105,52.81632,281,1.054786508091246
13,0,74,26,26,Grevesmühlen,23936,52.38,10538,5127,5411,201,0.0,1.0,2077.0,111.0,11.184913,53.864458,-284,0.9475143226760303
8,3,16,5005,12,Endingen am Kaiserstuhl,79346,26.7,10532,5219,5313,394,0.0,1.0,2527.402263880467,109.5,7.701325,48.142314,-94,0.9823075475249389
14,5,22,140,140,Flöha,9557,27.76,10516,5062,5454,379,0.0,1.0,1408.3589717233335,110.3,13.072994,50.858511,-392,0.9281261459479281
9,7,74,121,121,Burgau,89331,25.92,10509,5300,5209,405,0.0,1.0,2799.0,110.5,10.406193,48.431944,91,1.0174697638702246
8,2,35,5008,79,Bad Wildbad,75323,105.22,10495,5211,5284,100,0.0,2.0,2417.1446879301366,109.5,8.551041,48.749188,-73,0.9861847085541257
15,0,86,55,55,Gommern,39245,160.11,10485,5093,5392,65,0.0,1.0,1714.7123256447667,110.7,11.825518,52.073221,-299,0.9445474777448071
14,5,22,5102,60,Burgstädt,9217,25.88,10475,5099,5376,405,0.0,2.0,1161.0,110.3,12.805883,50.920143,-277,0.9484747023809523
14,5,21,460,460,Olbernhau,9526,125.35,10458,5138,5320,83,0.0,1.0,1226.1089717233335,110.3,13.339236,50.659281,-182,0.9657894736842105
6,5,31,13,13,Lollar,35457,21.39,10454,5168,5286,489,0.0,4.0,2452.5,109.8,8.705492,50.650039,-118,0.9776768823306848
8,2,35,80,80,Wildberg,72218,56.68,10443,5325,5118,184,0.0,2.0,2572.8946879301366,109.5,8.746753,48.625146,207,1.0404454865181711
5,3,58,44,44,Nideggen,52385,65.04,10419,5088,5331,160,0.0,2.0,1971.0,110.4,6.484282,50.692254,-243,0.9544175576814856
9,2,77,145,145,Simbach a.Inn,84359,47.33,10416,5056,5360,220,0.0,5.0,2683.7553448827384,110.5,13.015233,48.262787,-304,0.9432835820895522
15,0,88,65,65,Braunsbedra,6242,74.4,10401,5188,5213,140,0.0,3.0,1594.6971737441054,110.7,11.883678,51.283795,-25,0.9952042969499328
13,0,71,29,29,Demmin,17109,82.06,10395,4939,5456,127,0.0,2.0,1132.0,111.0,13.038196,53.905543,-517,0.905241935483871
6,5,34,16,16,Neustadt (Hessen),35279,56.86,10393,5568,4825,183,0.0,1.0,1809.4172793215403,109.8,9.114982,50.852589,743,1.1539896373056995
14,6,27,180,180,Nossen,1683,122.74,10389,5196,5193,85,0.0,2.0,1033.1013957730029,110.3,13.299465,51.058625,3,1.000577700751011
8,1,25,5009,69,Neuenstadt am Kocher,74196,41.17,10372,5189,5183,252,0.0,6.0,3085.0,109.5,9.330987,49.237185,6,1.0011576307158017
6,4,35,28,28,Steinau an der Straße,36396,104.86,10371,5129,5242,99,0.0,6.0,2037.8793995698943,109.8,9.461969,50.313016,-113,0.9784433422357879
7,3,39,5006,42,Nieder-Olm,55268,11.22,10362,5001,5361,924,0.0,1.0,2778.1672793215403,109.8,8.203097,49.909864,-360,0.9328483491885842
8,4,36,8,8,Aulendorf,88326,52.33,10338,5202,5136,198,0.0,1.0,2824.5,109.5,9.638492,47.951301,66,1.0128504672897196
9,6,76,122,122,Erlenbach a.Main,63906,16.31,10326,5126,5200,633,0.0,1.0,2459.0356486840537,110.5,9.160594,49.802337,-74,0.9857692307692307
8,1,16,5008,70,Weilheim an der Teck,73235,26.51,10324,5167,5157,389,0.0,2.0,3632.5,109.5,9.537362,48.615689,10,1.0019391118867558
3,1,59,3,3,Bad Lauterberg im Harz,37431,41.56,10297,4957,5340,248,0.0,5.0,2405.063652480945,110.0,10.46544,51.626737,-383,0.9282771535580524
15,0,90,550,550,Tangermünde,39590,89.99,10283,4903,5380,114,0.0,1.0,2110.4623256447667,110.7,11.973666,52.549088,-477,0.9113382899628253
6,4,37,16,16,Oberzent,64760,165.61,10280,5117,5163,62,0.0,1.0,1636.0,109.8,8.9735,49.567461,-46,0.9910904512880109
9,2,78,118,118,Bogen,94327,49.74,10278,5139,5139,207,0.0,1.0,2570.2856486840537,110.5,12.689145,48.909881,0,1.0
8,3,26,5,5,Blumberg,78176,98.72,10256,5171,5085,104,0.0,1.0,2083.0,109.5,8.534256,47.839705,86,1.016912487708948
15,0,88,305,305,Querfurt,6268,155.62,10256,4948,5308,66,0.0,3.0,1607.9471737441054,110.7,11.597433,51.37863,-360,0.9321778447626224
8,1,17,5006,49,Süßen,73079,12.79,10248,5111,5137,801,0.0,4.0,3070.6295360294826,109.5,9.757236,48.680177,-26,0.9949386801635196
7,1,32,5009,6,Betzdorf,57518,9.56,10223,5024,5199,1069,0.0,2.0,1651.0,109.8,7.882849,50.77617,-175,0.9663396807078284
3,2,56,25,25,Rehburg-Loccum,31547,99.97,10199,5132,5067,102,0.0,1.0,1913.0939562822605,110.0,9.225712,52.470153,65,1.012828103414249
9,1,76,114,114,Beilngries,92339,100.02,10195,5196,4999,102,0.0,1.0,3467.5,110.5,11.471047,49.03653,197,1.0394078815763153
1,0,54,5489,88,Niebüll,25899,30.63,10192,4902,5290,333,0.0,4.0,2609.791197549115,109.4,8.860437,54.822786,-388,0.9266540642722118
9,4,75,154,154,Münchberg,95213,68.78,10179,4938,5241,148,0.0,4.0,1350.0,110.5,11.789822,50.191739,-303,0.9421866056096165
16,0,62,5054,66,Bleicherode,99752,108.17,10163,5073,5090,94,0.0,2.0,2097.8814266551562,110.9,10.609569,51.472501,-17,0.9966601178781925
16,0,77,32,32,Meuselwitz,4610,53.66,10117,4877,5240,189,0.0,4.0,1016.0,110.9,12.29949,51.04228,-363,0.9307251908396946
8,1,36,5006,28,Heubach,73540,25.78,10063,4960,5103,390,0.0,2.0,2737.6446879301366,109.5,9.934626,48.78878,-143,0.9719772682735646
6,4,39,13,13,Rüdesheim am Rhein,65385,51.41,10054,4980,5074,196,0.0,2.0,2305.4097033712096,109.8,7.926648,49.979366,-94,0.9814741821048483
6,5,35,16,16,Schotten,63679,133.56,10045,5105,4940,75,0.0,2.0,1493.0,109.8,9.124329,50.502258,165,1.0334008097165992
9,6,77,131,131,Gemünden a.Main,97737,75.06,10041,5016,5025,134,0.0,3.0,2442.0204967833924,110.5,9.700757,50.051307,-9,0.9982089552238806
12,0,72,426,426,Trebbin,14959,126.36,10016,5051,4965,79,0.0,4.0,1757.189597793782,110.7,13.217345,52.218103,86,1.0173212487411882
1,0,60,92,92,Wahlstedt,23812,15.75,9998,4848,5150,635,0.0,4.0,2143.0,109.4,10.214464,53.952343,-302,0.9413592233009709
8,4,37,5002,76,Mengen,88512,49.82,9995,5020,4975,201,0.0,4.0,2699.8795360294826,109.5,9.329165,48.048768,45,1.0090452261306533
16,0,65,3,3,Bad Frankenhausen/Kyffhäuser,6567,91.06,9995,4936,5059,110,0.0,1.0,1173.889002605487,110.9,11.100746,51.357318,-123,0.9756868946432101
6,4,40,17,17,Niddatal,61194,40.25,9988,4941,5047,248,0.0,2.0,2921.5,109.8,8.815266,50.29758,-106,0.9789974242124034
6,6,34,7,7,Gudensberg,34281,46.49,9983,4966,5017,215,0.0,1.0,1825.1672793215403,109.8,9.366029,51.178409,-51,0.9898345624875423
10,0,41,511,511,Friedrichsthal,66299,8.99,9958,4836,5122,1108,0.0,1.0,1549.5,109.2,7.09686,49.32234,-286,0.9441624365482234
14,5,23,5122,300,Oelsnitz/Vogtl.,8606,53.66,9951,4843,5108,185,0.0,1.0,1206.8589717233335,110.3,12.100476,50.39717,-265,0.9481205951448708
6,4,37,1,1,Bad König,64732,46.73,9951,4798,5153,213,0.0,2.0,2128.0,109.8,9.005106,49.743868,-355,0.9311080923733748
8,1,16,81,81,Aichtal,72631,23.6,9951,4985,4966,422,0.0,2.0,2737.8946879301366,109.5,9.236006,48.621,19,1.0038260169150222
3,3,60,5407,2,Bad Bevensen,29549,48.37,9943,4568,5375,206,0.0,2.0,2011.5,110.0,10.575419,53.080198,-807,0.8498604651162791
7,1,41,5010,6,Bad Ems,56130,15.41,9936,4819,5117,645,0.0,3.0,2713.402127420879,109.8,7.712321,50.33497,-298,0.9417627516122729
1,0,55,33,33,Oldenburg in Holstein,23758,39.69,9922,4764,5158,250,0.0,2.0,2493.306349449769,109.4,10.88815,54.293241,-394,0.9236138037999224
6,5,35,15,15,Schlitz,36110,142.06,9892,4939,4953,70,0.0,4.0,1379.5,109.8,9.558584,50.675319,-14,0.9971734302442964
9,5,71,165,165,Heilsbronn,91560,62.23,9875,4904,4971,159,0.0,1.0,2341.5356486840537,110.5,10.786643,49.339366,-67,0.9865218265942466
12,0,61,332,332,Mittenwalde,15749,99.13,9854,4991,4863,99,0.0,1.0,2991.0,110.7,13.536256,52.264886,128,1.0263212009047913
3,2,54,8,8,Bockenem,31167,109.96,9830,4942,4888,89,0.0,3.0,1960.5788043815992,110.0,10.128926,52.009625,54,1.0110474631751227
13,0,75,105,105,Pasewalk,17309,55.21,9811,4658,5153,178,0.0,2.0,1545.2197651355164,111.0,13.990282,53.505112,-495,0.9039394527459732
12,0,64,29,29,Altlandsberg,15345,106.6,9808,4833,4975,92,0.0,3.0,3097.0,110.7,13.728164,52.566902,-142,0.9714572864321608
6,5,31,10,10,Laubach,35321,97.01,9801,4780,5021,101,0.0,2.0,1778.4097033712096,109.8,8.99015,50.542551,-241,0.952001593308106
8,2,35,5004,8,Bad Liebenzell,75378,33.78,9795,4817,4978,290,0.0,2.0,2605.3946879301366,109.5,8.73361,48.771372,-161,0.967657693852953
3,3,57,51,51,Visselhövede,27374,159.2,9792,4793,4999,62,0.0,1.0,1558.0,110.0,9.580361,52.985561,-206,0.9587917583516703
15,0,85,228,228,Oberharz am Brocken,38875,271.52,9754,4781,4973,36,0.0,1.0,1675.2123256447667,110.7,10.803213,51.769516,-192,0.9613915141765534
15,0,88,216,216,Wettin-Löbejün,6193,127.14,9747,4807,4940,77,0.0,2.0,1265.0,110.7,11.901719,51.637419,-133,0.9730769230769231
7,1,31,5003,6,Bad Breisig,53498,19.93,9740,4774,4966,489,0.0,2.0,2431.9097033712096,109.8,7.298459,50.509814,-192,0.9613370922271446
3,4,59,5403,17,Fürstenau,49584,78.64,9736,4771,4965,124,0.0,1.0,1983.3439562822605,110.0,7.674799,52.516666,-194,0.9609264853977845
7,3,31,5007,55,Osthofen,67574,18.62,9736,4777,4959,523,0.0,4.0,2598.0,109.8,8.322551,49.703765,-182,0.9632990522282718
3,1,55,3,3,Dassel,37586,113.24,9698,4818,4880,86,0.0,2.0,2030.5863803319298,110.0,9.687833,51.803,-62,0.9872950819672132
3,3,55,9,9,Bleckede,21354,140.65,9694,4661,5033,69,0.0,3.0,2143.5,110.0,10.732726,53.291349,-372,0.926087820385456
15,0,81,280,280,Klötze,38486,278.76,9680,4771,4909,35,0.0,1.0,1663.2123256447667,110.7,11.161472,52.626213,-138,0.9718883683031168
14,6,25,200,200,Großröhrsdorf,1900,40.94,9679,4769,4910,236,0.0,2.0,1236.1013957730029,110.3,14.024289,51.143211,-141,0.9712830957230143
14,7,29,70,70,Brandis,4821,34.89,9676,4791,4885,277,0.0,2.0,1219.3513957730029,110.3,12.609467,51.333915,-94,0.9807574206755374
16,0,67,5050,53,Ohrdruf,99885,113.6,9613,4790,4823,85,0.0,3.0,1319.0,110.9,10.722582,50.780014,-33,0.9931577856106159
3,3,54,5407,18,Lüchow (Wendland),29439,89.46,9612,4641,4971,107,0.0,1.0,1764.0939562822605,110.0,11.161706,52.967743,-330,0.9336149668074833
9,3,75,148,148,Hemau,93155,122.34,9599,4947,4652,78,0.0,2.0,2373.278072733723,110.5,11.781339,49.053299,295,1.0634135855546
13,0,73,35,35,Grimmen,18507,50.51,9586,4481,5105,190,0.0,2.0,1531.5,111.0,13.043192,54.113133,-624,0.8777668952007835
15,0,90,415,415,Osterburg (Altmark),39606,229.81,9580,4603,4977,42,0.0,1.0,1860.9623256447667,110.7,11.753617,52.787899,-374,0.9248543299176211
9,6,76,139,139,Miltenberg,63897,60.25,9566,4650,4916,159,0.0,3.0,2592.5,110.5,9.257405,49.701266,-266,0.9458909682668837
3,1,55,1,1,Bad Gandersheim,37581,90.85,9552,4624,4928,105,0.0,2.0,2075.58638033193,110.0,10.024463,51.870567,-304,0.9383116883116883
14,5,24,320,320,Wilkau-Haßlau,8112,12.65,9534,4520,5014,754,0.0,1.0,1840.8589717233335,110.3,12.515553,50.673643,-494,0.9014758675708018
14,6,28,360,360,Sebnitz,1855,88.23,9522,4665,4857,108,0.0,1.0,1077.5,110.3,14.269264,50.972858,-192,0.9604694255713403
12,0,67,481,481,Storkow (Mark),15859,180.72,9512,4686,4826,53,0.0,2.0,1616.204749694436,110.7,13.932683,52.257122,-140,0.9709904682967261
7,1,43,5003,32,Höhr-Grenzhausen,56203,15.88,9509,4583,4926,599,0.0,1.0,2612.1672793215403,109.8,7.66835,50.434108,-343,0.9303694681282988
12,0,61,320,320,Luckau,15926,207.44,9501,4700,4801,46,0.0,1.0,1680.0,110.7,13.642563,51.832852,-101,0.9789627161008123
15,0,85,190,190,Ilsenburg (Harz),38871,62.97,9477,4661,4816,151,0.0,2.0,1966.704749694436,110.7,10.679796,51.865815,-155,0.9678156146179402
9,7,73,5718,182,Wertingen,86637,51.88,9470,4732,4738,183,0.0,3.0,2241.5204967833924,110.5,10.640403,48.557831,-6,0.9987336428872943
15,0,91,160,160,Kemberg,6901,235.27,9467,4696,4771,40,0.0,3.0,1211.5,110.7,12.633727,51.772478,-75,0.9842800251519598
9,1,71,132,132,Töging a.Inn,84513,13.65,9465,4642,4823,693,0.0,5.0,3111.2553448827384,110.5,12.586743,48.254645,-181,0.9624714907733776
6,5,33,13,13,Runkel,65594,43.71,9457,4733,4724,216,0.0,2.0,2243.9097033712096,109.8,8.156881,50.405383,9,1.0019051651143098
15,0,84,235,235,Hohenmölsen,6679,75.32,9457,4590,4867,126,0.0,3.0,1662.1971737441054,110.7,12.099888,51.156346,-277,0.943086089993836
9,3,76,149,149,Nittenau,93149,98.73,9449,4751,4698,96,0.0,1.0,2092.5,110.5,12.268896,49.196567,53,1.0112813963388676
16,0,66,69,69,Steinbach-Hallenberg,98587,76.73,9408,4631,4777,123,0.0,1.0,2215.889002605487,110.9,10.568215,50.699769,-146,0.9694368850743145
9,7,74,5730,143,Ichenhausen,89335,34.27,9372,4808,4564,273,0.0,3.0,2334.7704967833924,110.5,10.305508,48.372441,244,1.0534618755477652
12,0,60,280,280,Werneuchen,16356,117.02,9369,4678,4691,80,0.0,4.0,2612.0,110.7,13.57961,52.576115,-13,0.9972287358772117
9,4,75,162,162,Rehau,95111,80.33,9369,4571,4798,117,0.0,1.0,2405.0356486840537,110.5,12.035833,50.248373,-227,0.952688620258441
5,7,66,52,52,Lügde,32676,88.64,9364,4618,4746,106,0.0,1.0,1578.1973102036936,110.4,9.245996,51.957888,-128,0.9730299199325748
7,3,33,5002,19,Eisenberg (Pfalz),67304,18.75,9362,4674,4688,499,0.0,1.0,2167.0,109.8,8.07207,49.557834,-14,0.9970136518771331
3,2,57,28,28,Obernkirchen,31683,32.45,9360,4695,4665,288,0.0,1.0,2139.3439562822605,110.0,9.130876,52.270718,30,1.0064308681672025
14,7,29,430,430,Zwenkau,4442,46.3,9332,4601,4731,202,0.0,2.0,2381.5,110.3,12.327259,51.217549,-130,0.9725216656098077
1,0,55,21,21,Heiligenhafen,23774,18.32,9330,4461,4869,509,0.0,2.0,2728.556349449769,109.4,10.974623,54.373048,-408,0.9162045594577942
13,0,75,5559,131,Torgelow,17358,72.19,9307,4568,4739,129,0.0,4.0,1481.2046132348623,111.0,13.978606,53.599818,-171,0.9639164380671028
5,5,66,88,88,Tecklenburg,49545,70.49,9288,4617,4671,132,0.0,1.0,2183.5,110.4,7.814244,52.219392,-54,0.9884393063583815
9,2,75,124,124,Bad Griesbach i.Rottal,94086,70.13,9285,4597,4688,132,0.0,3.0,2567.2704967833924,110.5,13.192962,48.451913,-91,0.9805887372013652
12,0,62,5031,24,Bad Liebenwerda,4924,138.88,9284,4529,4755,67,0.0,2.0,1187.204749694436,110.7,13.394139,51.515956,-226,0.9524710830704521
9,3,73,126,126,Freystadt,92342,80.56,9265,4763,4502,115,0.0,1.0,2361.5356486840537,110.5,11.328203,49.199011,261,1.0579742336739226
8,4,26,5006,87,Ochsenhausen,88416,59.96,9261,4739,4522,154,0.0,1.0,2686.0,109.5,9.974997,48.063201,217,1.0479876160990713
7,1,37,5008,228,Weißenthurm,56575,3.99,9259,4745,4514,2321,0.0,4.0,4283.394551470556,109.8,7.455206,50.415706,231,1.0511741249446167
5,7,54,4,4,Borgholzhausen,33829,55.99,9253,4604,4649,165,0.0,1.0,1559.9473102036936,110.4,8.300771,52.101931,-45,0.9903204990320499
14,6,26,370,370,Niesky,2906,53.82,9249,4433,4816,172,0.0,1.0,1188.0,110.3,14.823061,51.293789,-383,0.9204734219269103
9,4,79,169,169,Wunsiedel,95632,54.88,9243,4520,4723,168,0.0,2.0,2549.278072733723,110.5,12.002966,50.037027,-203,0.9570188439551133
9,7,79,201,201,Rain,86641,77.13,9238,4604,4634,120,0.0,3.0,3016.0,110.5,10.921054,48.690496,-30,0.9935261113508848
7,3,34,5004,13,Kandel,76870,26.69,9212,4501,4711,345,0.0,2.0,2488.1597033712096,109.8,8.192761,49.081369,-210,0.9554234769687965
3,4,61,4,4,Elsfleth,26931,115.19,9204,4683,4521,80,0.0,1.0,1793.0,110.0,8.457116,53.237137,162,1.0358327803583278
13,0,73,80,80,Sassnitz,18546,47.41,9199,4362,4837,194,0.0,2.0,1552.2197651355164,111.0,13.634476,54.51304,-475,0.901798635517883
3,2,54,14,14,Elze,31008,47.81,9176,4548,4628,192,0.0,1.0,2015.5939562822605,110.0,9.735897,52.121655,-80,0.982713915298185
15,0,82,440,440,Zörbig,6780,113.69,9153,4516,4637,81,0.0,4.0,1093.0,110.7,12.122807,51.628453,-121,0.9739055423765366
12,0,68,264,264,Kyritz,16866,157.38,9152,4442,4710,58,0.0,2.0,1549.704749694436,110.7,12.396931,52.940717,-268,0.943099787685775
7,1,37,5007,226,Vallendar,56179,13.22,9151,4382,4769,692,0.0,3.0,2923.5,109.8,7.606683,50.39585,-387,0.9188509121409101
8,3,37,66,66,Laufenburg (Baden),79725,23.57,9136,4485,4651,388,0.0,1.0,2789.902263880467,109.5,8.061623,47.565321,-166,0.9643087508062782
7,1,37,5004,69,Mendig,56743,23.75,9128,4485,4643,384,0.0,2.0,2135.0,109.8,7.280288,50.372828,-158,0.965970277837605
8,4,26,5002,14,Bad Schussenried,88427,55.01,9118,4589,4529,166,0.0,3.0,2513.637111979806,109.5,9.657495,48.004849,60,1.0132479576065356
1,0,62,61,61,Reinfeld (Holstein),23858,17.37,9110,4505,4605,524,0.0,1.0,2749.3139254001,109.4,10.488565,53.8315,-100,0.9782844733984799
15,0,91,391,391,Zahna-Elster,6895,148.67,9106,4540,4566,61,0.0,2.0,1233.0,110.7,12.829442,51.829561,-26,0.994305738063951
9,3,71,113,113,Auerbach i.d.OPf.,91275,78.26,9066,4472,4594,116,0.0,3.0,2443.7704967833924,110.5,11.6291,49.691728,-122,0.9734436221158033
9,2,76,148,148,Zwiesel,94227,41.16,9045,4406,4639,220,0.0,1.0,2602.2856486840537,110.5,13.254505,49.03578,-233,0.9497736581159733
9,3,73,112,112,Berching,92334,131.18,9044,4594,4450,69,0.0,2.0,2765.0,110.5,11.444396,49.104465,144,1.0323595505617977
5,9,54,4,4,Breckerfeld,58339,59.09,9041,4443,4598,153,0.0,2.0,1771.689734253363,110.4,7.46522,51.261435,-155,0.9662896911700739
14,5,22,570,570,Waldheim,4736,41.71,9033,4670,4363,217,0.0,2.0,1041.5,110.3,13.017355,51.073265,307,1.0703644281457712
12,0,62,92,92,Doberlug-Kirchhain,3253,150.36,9032,4594,4438,60,0.0,1.0,1217.2123256447667,110.7,13.561167,51.635945,156,1.035150968904912
9,3,72,126,126,Furth im Wald,93437,67.06,9032,4540,4492,135,0.0,1.0,2405.0356486840537,110.5,12.842882,49.308018,48,1.0106856634016028
3,3,52,5407,22,Hemmoor,21745,45.07,9026,4373,4653,200,0.0,3.0,1649.5,110.0,9.153373,53.692362,-280,0.9398237696110037
16,0,75,5050,73,Neustadt an der Orla,7806,86.08,9017,4390,4627,105,0.0,2.0,1249.6314266551562,110.9,11.69059,50.728861,-237,0.9487789064188459
14,5,22,50,50,Brand-Erbisdorf,9618,46.33,9010,4409,4601,194,0.0,2.0,1137.5,110.3,13.32197,50.869411,-192,0.958269941317105
6,5,34,21,21,Wetter (Hessen),35083,104.53,9010,4499,4511,86,0.0,2.0,1771.4097033712096,109.8,8.723954,50.903328,-12,0.9973398359565506
8,3,26,5002,17,Furtwangen im Schwarzwald,78120,82.57,9004,4581,4423,109,0.0,2.0,2327.6446879301366,109.5,8.205476,48.051584,158,1.0357223603888763
9,1,71,125,125,Neuötting,84524,36.6,8997,4517,4480,246,0.0,1.0,2944.5,110.5,12.690715,48.240061,37,1.0082589285714285
14,5,21,5138,690,Zschopau,9405,22.79,8996,4283,4713,395,0.0,2.0,1673.6013957730029,110.3,13.030181,50.760222,-430,0.9087629959685974
6,4,40,19,19,Ortenberg,63683,54.7,8962,4439,4523,164,0.0,1.0,2221.6672793215403,109.8,9.054158,50.35609,-84,0.981428255582578
1,0,57,57,57,Plön,24306,36.76,8941,4205,4736,243,0.0,2.0,2828.0,109.4,10.490762,54.14153,-531,0.8878800675675675
15,0,88,25,25,Bad Lauchstädt,6246,85.4,8939,4395,4544,105,0.0,2.0,1496.204749694436,110.7,11.867012,51.387158,-149,0.9672095070422535
16,0,72,5051,13,Neuhaus am Rennweg,98724,108.22,8927,4535,4392,82,0.0,4.0,923.0,110.9,11.159835,50.476118,143,1.032559198542805
6,4,40,7,7,Florstadt,61197,39.6,8901,4371,4530,225,0.0,2.0,2302.9097033712096,109.8,8.861417,50.318669,-159,0.9649006622516556
9,4,71,140,140,Hallstadt,96103,14.6,8876,4411,4465,608,0.0,2.0,3116.5,110.5,10.875159,49.928417,-54,0.9879059350503919
16,0,75,98,98,Schleiz,7907,108.21,8866,4526,4340,82,0.0,3.0,1343.3738507048256,110.9,11.807287,50.577418,186,1.042857142857143
15,0,82,301,301,Raguhn-Jeßnitz,6779,97.3,8861,4299,4562,91,0.0,1.0,1545.2123256447667,110.7,12.268773,51.708263,-263,0.9423498465585269
3,4,59,5402,10,Bersenbrück,49593,42.54,8850,4352,4498,208,0.0,2.0,1772.5,110.0,7.947724,52.555167,-146,0.9675411293908404
9,6,75,5619,174,Volkach,97332,60.19,8843,4436,4407,147,0.0,1.0,2277.7856486840537,110.5,10.226896,49.864209,29,1.0065804402087588
14,7,29,5307,300,Naunhof,4683,39.71,8839,4300,4539,223,0.0,2.0,2315.0,110.3,12.549364,51.23412,-239,0.9473452302269222
9,6,76,145,145,Obernburg a.Main,63785,24.82,8801,4326,4475,355,0.0,1.0,2229.0356486840537,110.5,9.143788,49.842701,-149,0.9667039106145251
15,0,85,40,40,Ballenstedt,6493,87.04,8794,4256,4538,101,0.0,2.0,1087.5,110.7,11.237514,51.72028,-282,0.9378580872631115
8,1,15,5006,48,Waldenbuch,71111,22.7,8779,4318,4461,387,0.0,3.0,2633.137111979806,109.5,9.12974,48.638166,-143,0.9679444070836135
13,0,73,5352,9,Barth,18356,41.18,8777,4144,4633,213,0.0,1.0,2261.5,111.0,12.72658,54.36871,-489,0.894452838333693
5,7,62,12,12,Borgentreich,34434,138.94,8761,4603,4158,63,0.0,1.0,1444.9473102036936,110.4,9.240386,51.571529,445,1.107022607022607
9,1,86,158,158,Vohburg a.d.Donau,85088,45.17,8756,4453,4303,194,0.0,2.0,2621.278072733723,110.5,11.619089,48.768066,150,1.0348594004183127
8,4,37,5003,78,Meßkirch,88605,76.22,8737,4442,4295,115,0.0,2.0,2229.0,109.5,9.111166,47.992608,147,1.0342258440046566
8,2,26,5006,65,Rauenberg,69231,11.12,8736,4330,4406,786,0.0,1.0,2907.652263880467,109.5,8.70473,49.266186,-76,0.9827507943713119
7,3,37,5002,5,Bad Bergzabern,76887,10.71,8732,4147,4585,815,0.0,1.0,2374.5,109.8,7.999155,49.100366,-438,0.9044711014176663
12,0,62,224,224,Herzberg (Elster),4916,149.01,8731,4218,4513,59,0.0,2.0,1371.704749694436,110.7,13.23544,51.69229,-295,0.9346332816308442
9,3,77,154,154,Tirschenreuth,95643,103.95,8655,4192,4463,83,0.0,2.0,2463.028072733723,110.5,12.33646,49.878232,-271,0.9392785122115169
7,3,39,5007,43,Nierstein,55283,19.34,8621,4223,4398,446,0.0,2.0,2399.9097033712096,109.8,8.337848,49.872587,-175,0.9602091859936335
5,7,66,12,12,Barntrup,32683,59.46,8611,4281,4330,145,0.0,1.0,1172.0,110.4,9.116339,51.990496,-49,0.9886836027713626
1,0,59,45,45,Kappeln,24376,43.33,8607,4141,4466,199,0.0,2.0,2483.806349449769,109.4,9.931158,54.659144,-325,0.9272279444693238
13,0,75,136,136,Ueckermünde,17373,85.87,8598,4178,4420,100,0.0,2.0,1459.2197651355164,111.0,14.046489,53.736513,-242,0.9452488687782805
9,2,76,144,144,Viechtach,94234,62.46,8585,4300,4285,137,0.0,2.0,1887.5,110.5,12.884245,49.081812,15,1.0035005834305717
6,5,31,17,17,Staufenberg,35460,28.58,8551,4237,4314,299,0.0,2.0,2001.9097033712096,109.8,8.732286,50.659884,-77,0.9821511358368104
7,1,32,5008,117,Wissen,57537,34.88,8543,4197,4346,245,0.0,2.0,1710.0,109.8,7.682865,50.803933,-149,0.9657156005522319
15,0,88,235,235,Mücheln (Geiseltal),6249,98.66,8542,4266,4276,87,0.0,2.0,1573.454749694436,110.7,11.807061,51.300764,-10,0.9976613657623947
8,3,36,5001,45,Kandern,79400,62.26,8537,4156,4381,137,0.0,2.0,3269.0,109.5,7.662899,47.714834,-225,0.9486418625884502
9,2,74,176,176,Rottenburg a.d.Laaber,84056,90.11,8533,4308,4225,95,0.0,2.0,2380.028072733723,110.5,12.027732,48.702367,83,1.0196449704142012
8,1,25,5007,63,Möckmühl,74219,49.6,8524,4354,4170,172,0.0,2.0,2463.5,109.5,9.359823,49.323117,184,1.0441247002398082
8,2,36,5005,43,Neuenbürg,75305,28.15,8518,4286,4232,303,0.0,2.0,2636.1446879301366,109.5,8.589759,48.848189,54,1.0127599243856333
8,3,15,5016,108,Staufen im Breisgau,79219,23.32,8503,4035,4468,365,0.0,2.0,2613.1446879301366,109.5,7.729921,47.880529,-433,0.903088630259624
8,2,16,5001,24,Kuppenheim,76456,18.08,8488,4174,4314,469,0.0,2.0,3506.5,109.5,8.254177,48.827747,-140,0.9675475197032916
8,1,18,21,21,Großbottwar,71723,25.51,8452,4216,4236,331,0.0,2.0,2633.3946879301366,109.5,9.292335,48.999692,-20,0.9952785646836638
7,1,33,5009,52,Kirn,55606,16.53,8450,4075,4375,511,0.0,2.0,2520.1597033712096,109.8,7.499054,49.824015,-300,0.9314285714285714
14,5,22,230,230,Hainichen,9661,51.74,8448,4149,4299,163,0.0,2.0,990.0,110.3,13.12406,50.968719,-150,0.9651081646894627
12,0,66,112,112,Großräschen/Rań,1983,81.86,8445,4158,4287,103,0.0,2.0,1392.454749694436,110.7,14.010831,51.588116,-129,0.9699090272918125
15,0,84,315,315,Lützen,6686,96.49,8439,4188,4251,87,0.0,2.0,1598.704749694436,110.7,12.141207,51.25541,-63,0.9851799576570219
13,0,72,106,106,Teterow,17166,47.07,8434,4122,4312,179,0.0,2.0,1518.9697651355164,111.0,12.575889,53.773591,-190,0.9559369202226345
15,0,87,275,275,Mansfeld,6343,143.76,8432,4237,4195,59,0.0,2.0,821.0,110.7,11.45461,51.594112,42,1.0100119189511323
7,1,32,5007,63,Kirchen (Sieg),57548,39.76,8431,4145,4286,212,0.0,2.0,2256.6597033712096,109.8,7.882897,50.808187,-141,0.9671021931871209
14,5,22,460,460,Penig,9322,63.37,8419,4151,4268,133,0.0,2.0,1368.1013957730029,110.3,12.706022,50.933482,-117,0.9725866916588566
7,3,31,5006,73,Wörrstadt,55286,16.75,8414,4192,4222,502,0.0,2.0,2912.0,109.8,8.092437,49.844475,-30,0.9928943628612033
9,3,76,147,147,Neunburg vorm Wald,92431,110.14,8413,4334,4079,76,0.0,2.0,2382.528072733723,110.5,12.381852,49.348813,255,1.0625153223829369
14,5,21,355,355,Lauter-Bernsbach,8315,30.28,8410,4075,4335,278,0.0,2.0,1453.8513957730029,110.3,12.736115,50.56018,-260,0.9400230680507498
6,6,36,1,1,Bad Sooden-Allendorf,37242,73.75,8394,4184,4210,114,0.0,2.0,1229.5,109.8,9.980802,51.272411,-26,0.9938242280285036
9,4,75,136,136,Helmbrechts,95233,58.72,8390,4133,4257,143,0.0,2.0,2473.778072733723,110.5,11.715874,50.236794,-124,0.9708715057552267
8,1,18,5003,10,Bönnigheim,74357,20.13,8381,4109,4272,416,0.0,2.0,2648.6446879301366,109.5,9.093322,49.041614,-163,0.9618445692883895
14,7,29,80,80,Colditz,4680,84.09,8381,4122,4259,100,0.0,2.0,1013.5,110.3,12.80675,51.125652,-137,0.9678328246067152
5,7,66,60,60,Schieder-Schwalenberg,32816,60.04,8363,4112,4251,139,0.0,3.0,1728.1821583030323,110.4,9.153219,51.913825,-139,0.9673018113385086
7,3,35,5011,22,Landstuhl,66849,15.34,8336,4013,4323,543,0.0,2.0,1891.5,109.8,7.568755,49.410247,-310,0.9282905389775619
12,0,63,244,244,Premnitz,14727,46.27,8335,4025,4310,180,0.0,2.0,1679.954749694436,110.7,12.337104,52.530804,-285,0.9338747099767981
1,0,61,5189,49,Kellinghusen,25548,18.81,8313,4125,4188,442,0.0,2.0,1823.0,109.4,9.685543,53.924664,-63,0.9849570200573066
16,0,70,48,48,Stadtilm,99326,120.26,8311,4115,4196,69,0.0,2.0,2201.1314266551562,110.9,11.086073,50.775669,-81,0.98069590085796
9,5,71,166,166,Herrieden,91567,81.66,8304,4143,4161,102,0.0,2.0,2366.0,110.5,10.495052,49.23568,-18,0.9956741167988464
8,2,37,5001,19,Dornstetten,72280,24.2,8301,4104,4197,343,0.0,2.0,2642.6446879301366,109.5,8.499599,48.470329,-93,0.9778413152251608
5,7,62,40,40,Willebadessen,34439,128.41,8288,4197,4091,65,0.0,3.0,1578.6821583030323,110.4,9.028703,51.624696,106,1.0259105353214373
9,6,77,114,114,Arnstein,97450,112.1,8257,4151,4106,74,0.0,2.0,851.5,110.5,9.966942,49.978736,45,1.010959571358987
8,2,36,33,33,Knittlingen,75438,26.33,8255,4034,4221,314,0.0,2.0,2745.8946879301366,109.5,8.758013,49.024124,-187,0.9556977019663587
3,3,54,5406,4,Dannenberg (Elbe),29451,76.62,8253,4073,4180,108,0.0,1.0,1144.5,110.0,11.090108,53.096496,-107,0.974401913875598
7,3,35,5008,38,Ramstein-Miesenbach,66877,43.01,8250,4040,4210,192,0.0,2.0,2256.4097033712096,109.8,7.551119,49.445736,-170,0.9596199524940617
14,5,22,310,310,Leisnig,4703,78.09,8249,4067,4182,106,0.0,2.0,1205.3513957730029,110.3,12.926623,51.159434,-115,0.9725011956001913
16,0,74,5014,41,Hermsdorf,7629,7.49,8227,4087,4140,1098,0.0,2.0,1756.0,110.9,11.856674,50.896145,-53,0.9871980676328502
8,3,17,5014,146,Zell am Harmersbach,77736,36.41,8227,4050,4177,226,0.0,2.0,2486.3946879301366,109.5,8.062103,48.346261,-127,0.9695954033995691
15,0,89,55,55,Calbe (Saale),39240,56.7,8222,4005,4217,145,0.0,2.0,1929.704749694436,110.7,11.774788,51.902787,-212,0.9497272942850368
8,2,35,5003,33,Bad Herrenalb,76332,33.01,8212,4009,4203,249,0.0,2.0,2390.0,109.5,8.438156,48.797568,-194,0.9538424934570545
12,0,67,36,36,Beeskow,15848,77.9,8210,3927,4283,105,0.0,2.0,1522.454749694436,110.7,14.24693,52.172338,-356,0.9168806911043661
16,0,76,5053,79,Weida,7570,36.8,8205,4013,4192,223,0.0,2.0,1005.0,110.9,11.957738,50.756945,-179,0.9572996183206107
9,2,72,120,120,Grafenau,94481,63.73,8200,4017,4183,129,0.0,2.0,2511.028072733723,110.5,13.397607,48.85871,-166,0.9603155629930672
14,7,29,5301,10,Bad Lausick,4651,70.02,8191,3978,4213,117,0.0,2.0,931.6013957730029,110.3,12.640283,51.144619,-235,0.9442202705910278
13,0,72,5252,20,Bützow,18246,39.85,8181,4178,4003,205,0.0,2.0,1451.5,111.0,11.878243,53.812379,175,1.0437172120909317
7,2,33,5001,501,Daun,54550,49.02,8179,4023,4156,167,0.0,2.0,2378.6597033712096,109.8,6.830555,50.196727,-133,0.9679980750721848
15,0,89,26,26,Barby,39249,153.2,8129,4062,4067,53,0.0,2.0,1067.0,110.7,11.880764,51.966471,-5,0.9987705925743792
15,0,91,20,20,Bad Schmiedeberg,6905,160.3,8107,3975,4132,51,0.0,2.0,1414.454749694436,110.7,12.732596,51.683995,-157,0.9620038722168441
5,9,58,28,28,Medebach,59964,126.05,8101,4066,4035,64,0.0,3.0,1550.5,110.4,8.704871,51.198074,31,1.0076827757125155
15,0,89,195,195,Könnern,6420,125.36,8094,4078,4016,65,0.0,2.0,1517.704749694436,110.7,11.767742,51.670127,62,1.0154382470119523
7,1,43,5005,62,Ransbach-Baumbach,56235,12.15,8082,3945,4137,665,0.0,2.0,2728.6597033712096,109.8,7.702876,50.470276,-192,0.9535895576504714
14,5,24,5111,130,Kirchberg,8107,39.56,8082,3932,4150,204,0.0,2.0,1209.5,110.3,12.547335,50.595343,-218,0.9474698795180723
14,6,25,310,310,Lauta,2991,42.14,8082,3946,4136,192,0.0,2.0,1269.8513957730029,110.3,14.098581,51.46142,-190,0.9540618955512572
9,5,72,115,115,Baiersdorf,91083,11.81,8076,4009,4067,684,0.0,2.0,3589.5,110.5,11.029029,49.655938,-58,0.9857388738627981
15,0,91,241,241,Oranienbaum-Wörlitz,6785,115.53,8067,4117,3950,70,0.0,2.0,1565.454749694436,110.7,12.404739,51.79801,167,1.0422784810126582
8,1,36,45,45,Neresheim,73450,118.51,8064,4141,3923,68,0.0,2.0,2204.5,109.5,10.336826,48.752577,218,1.0555697170532756
13,0,72,60,60,Kühlungsborn,18225,16.17,8037,3698,4339,497,0.0,2.0,1826.4697651355164,111.0,11.751251,54.141683,-641,0.8522701083198894
7,1,40,5008,144,Simmern/ Hunsrück,55469,11.96,8035,3845,4190,672,0.0,2.0,2758.6597033712096,109.8,7.567389,49.994498,-345,0.9176610978520287
7,2,35,5001,45,Hermeskeil,54411,30.89,8013,4540,3473,259,0.0,2.0,1976.5,109.8,7.050884,49.753106,1067,1.307227181111431
8,1,36,50,50,Oberkochen,73447,23.55,8002,3950,4052,340,0.0,2.0,2797.8946879301366,109.5,10.105585,48.784042,-102,0.9748272458045409
7,3,33,5004,39,Kirchheimbolanden,67292,26.36,7998,3869,4129,303,0.0,2.0,2106.5,109.8,8.010665,49.664151,-260,0.9370307580527973
7,2,35,5006,125,Schweich,54338,31.08,7992,3823,4169,257,0.0,2.0,2287.9097033712096,109.8,6.79032,49.804046,-346,0.917006476373231
9,7,73,5713,136,Gundelfingen a.d.Donau,89423,54.06,7983,4010,3973,148,0.0,2.0,2167.278072733723,110.5,10.367549,48.549064,37,1.0093128618172666
8,3,26,5001,27,Hüfingen,78183,58.53,7976,3956,4020,136,0.0,2.0,2559.5,109.5,8.488945,47.9255,-64,0.9840796019900497
15,0,84,490,490,Teuchern,6682,81.36,7974,4014,3960,98,0.0,2.0,1706.204749694436,110.7,12.022043,51.118406,54,1.0136363636363637
12,0,68,353,353,Rheinsberg,16831,328.14,7948,3906,4042,24,0.0,2.0,2179.5,110.7,12.892207,53.099024,-136,0.9663532904502722
15,0,90,70,70,Bismark (Altmark),39629,289.49,7909,3970,3939,27,0.0,2.0,1647.704749694436,110.7,11.555013,52.661431,31,1.0078700177710078
14,7,30,20,20,Bad Düben,4849,45.8,7880,3694,4186,172,0.0,2.0,1121.8513957730029,110.3,12.585782,51.592198,-492,0.8824653607262303
7,2,33,5006,26,Gerolstein,54568,64.43,7876,3903,3973,122,0.0,2.0,1504.0,109.8,6.659875,50.221958,-70,0.9823810722376038
14,5,21,370,370,Lößnitz,8294,30.49,7871,3867,4004,258,0.0,2.0,1438.6013957730029,110.3,12.732369,50.622709,-137,0.9657842157842158
14,6,28,5201,10,Altenberg,1773,145.9,7870,3909,3961,54,0.0,2.0,815.8513957730029,110.3,13.757485,50.766607,-52,0.986872002019692
16,0,71,5051,4,Bad Sulza,99518,91.14,7864,3881,3983,86,0.0,2.0,1280.5,110.9,11.623826,51.086787,-102,0.9743911624403716
14,5,21,5115,380,Lugau/Erzgeb.,9385,22.29,7844,3824,4020,352,0.0,2.0,1459.1013957730029,110.3,12.746491,50.739952,-196,0.9512437810945273
9,3,76,170,170,Teublitz,93158,38.23,7820,3880,3940,205,0.0,2.0,2587.028072733723,110.5,12.08483,49.220722,-60,0.9847715736040609
12,0,62,124,124,Elsterwerda,4910,40.58,7792,3798,3994,192,0.0,2.0,1192.0,110.7,13.520152,51.460775,-196,0.9509263895843766
14,5,22,440,440,Oederan,9569,77.33,7782,3838,3944,101,0.0,2.0,1321.3513957730029,110.3,13.166415,50.861806,-106,0.9731237322515213
12,0,65,165,165,Kremmen,16766,209.54,7781,3843,3938,37,0.0,2.0,1409.704749694436,110.7,13.026328,52.76282,-95,0.9758760792280345
14,5,23,160,160,Klingenthal,8248,50.44,7764,3771,3993,154,0.0,2.0,751.5,110.3,12.469861,50.358646,-222,0.9444027047332832
8,3,15,5010,70,Löffingen,79843,88.02,7744,3906,3838,88,0.0,2.0,2285.3946879301366,109.5,8.343862,47.883793,68,1.0177175612298073
16,0,63,99,99,Bad Liebenstein,36448,48.81,7735,3728,4007,158,0.0,2.0,1272.5,110.9,10.34924,50.815751,-279,0.9303718492637884
15,0,89,307,307,Seeland,6469,78.93,7735,3839,3896,98,0.0,2.0,1648.454749694436,110.7,11.333106,51.800127,-57,0.9853696098562629
8,1,28,126,126,Weikersheim,97990,80.93,7732,3816,3916,96,0.0,2.0,2468.0,109.5,9.902462,49.482875,-100,0.9744637385086823
12,0,66,320,320,Vetschau/Spreewald / Wětošow/Błota,3226,111.42,7723,3805,3918,69,0.0,2.0,1461.204749694436,110.7,14.07382,51.783746,-113,0.9711587544665645
3,1,55,5,5,Hardegsen,37181,84.03,7715,3803,3912,92,0.0,2.0,2060.08638033193,110.0,9.829689,51.650579,-109,0.9721370143149284
9,4,75,156,156,Naila,95119,37.04,7711,3734,3977,208,0.0,2.0,2562.778072733723,110.5,11.706881,50.330343,-243,0.9388986673371889
14,5,23,5134,430,Treuen,8233,43.74,7704,3755,3949,176,0.0,2.0,976.0,110.3,12.307471,50.54268,-194,0.950873638895923
15,0,85,145,145,Harzgerode,6493,164.68,7698,3783,3915,47,0.0,2.0,1428.454749694436,110.7,11.237514,51.72028,-132,0.9662835249042145
14,5,23,5107,120,Falkenstein/Vogtl.,8223,31.06,7692,3666,4026,248,0.0,2.0,1231.1013957730029,110.3,12.370054,50.476123,-360,0.910581222056632
12,0,66,52,52,Calau/Kalawa,3205,163.49,7660,3786,3874,47,0.0,2.0,1258.704749694436,110.7,13.949411,51.74682,-88,0.977284460505937
7,2,35,5008,118,Saarburg,54439,20.63,7597,3661,3936,368,0.0,2.0,2718.0,109.8,6.486112,49.62074,-275,0.9301321138211383
9,6,72,135,135,Münnerstadt,97702,93.11,7596,3839,3757,82,0.0,2.0,2303.528072733723,110.5,10.195481,50.248726,82,1.0218259249401118
9,3,74,162,162,Vohenstrauß,92648,74.91,7590,3731,3859,101,0.0,2.0,2448.528072733723,110.5,12.341779,49.623078,-128,0.9668307851775071
8,1,25,39,39,Gundelsheim,74831,38.44,7586,3808,3778,197,0.0,2.0,3249.0,109.5,9.160815,49.284163,30,1.007940709370037
9,3,73,151,151,Parsberg,92331,57.32,7581,3855,3726,132,0.0,2.0,2461.528072733723,110.5,11.756015,49.154803,129,1.034621578099839
14,7,30,45,45,Belgern-Schildau,4874,158.99,7577,3779,3798,48,0.0,3.0,1077.0,110.3,12.927299,51.456594,-19,0.9949973670352817
6,4,37,4,4,Breuberg,64747,30.76,7577,3748,3829,246,0.0,2.0,2342.1597033712096,109.8,9.018078,49.819229,-81,0.9788456516061634
6,6,36,11,11,Sontra,36205,111.28,7561,3812,3749,68,0.0,2.0,1724.5347033712096,109.8,9.93321,51.068954,63,1.0168044811949852
7,3,39,5007,49,Oppenheim,55276,7.1,7560,3649,3911,1065,0.0,2.0,3060.5,109.8,8.350227,49.839373,-262,0.9330094604960368
15,0,87,15,15,Allstedt,6542,149.85,7553,3775,3778,50,0.0,2.0,1382.704749694436,110.7,11.385673,51.404566,-3,0.9992059290629963
14,7,29,170,170,Groitzsch,4539,70.17,7551,3603,3948,108,0.0,2.0,1108.7263957730029,110.3,12.281022,51.154307,-345,0.912613981762918
12,0,69,632,632,Treuenbrietzen,14929,212.43,7522,3652,3870,35,0.0,2.0,1875.0,110.7,12.870622,52.094645,-218,0.9436692506459948
6,5,35,9,9,Homberg (Ohm),35315,88.04,7521,3813,3708,85,0.0,2.0,1782.2847033712096,109.8,8.997428,50.728382,105,1.02831715210356
9,7,74,155,155,Leipheim,89340,32.16,7500,3885,3615,233,0.0,2.0,2874.0,110.5,10.223257,48.448055,270,1.0746887966804979
8,3,16,5002,10,Elzach,79215,75.28,7477,3717,3760,99,0.0,2.0,2278.2696879301366,109.5,8.034739,48.193856,-43,0.988563829787234
9,3,72,137,137,Bad Kötzting,93444,62.15,7466,3678,3788,120,0.0,2.0,2457.028072733723,110.5,12.854868,49.174806,-110,0.970960929250264
3,3,52,5411,46,Otterndorf,21762,33.55,7458,3512,3946,222,0.0,2.0,3109.0,110.0,8.941582,53.778337,-434,0.8900152052711606
14,6,27,220,220,Radeburg,1471,54.02,7451,3699,3752,138,0.0,2.0,1157.6013957730029,110.3,13.723805,51.215453,-53,0.9858742004264393
14,5,21,495,495,Pockau-Lengefeld,9514,83.43,7445,3697,3748,89,0.0,2.0,1325.2263957730029,110.3,13.192592,50.720097,-51,0.986392742796158
8,3,17,5009,110,Renchen,77871,32.08,7433,3725,3708,232,0.0,2.0,2866.5,109.5,8.013581,48.587888,17,1.0045846817691477
9,1,72,122,122,Laufen,83410,35.28,7431,3738,3693,211,0.0,2.0,2522.028072733723,110.5,12.932686,47.936943,45,1.0121852152721365
3,4,62,5401,3,Esens,26427,21.67,7427,3492,3935,343,0.0,2.0,2388.0,110.0,7.643871,53.597359,-443,0.887420584498094
16,0,69,12,12,Eisfeld,98673,86.52,7412,3718,3694,86,0.0,2.0,2206.2564266551562,110.9,10.907349,50.427398,24,1.0064970221981593
15,0,81,240,240,Kalbe (Milde),39624,272.84,7407,3755,3652,27,0.0,2.0,1688.204749694436,110.7,11.389156,52.656091,103,1.0282037239868564
3,1,59,4,4,Bad Sachsa,37441,33.2,7406,3566,3840,223,0.0,2.0,1030.5,110.0,10.552027,51.594452,-274,0.9286458333333333
8,1,25,7,7,Bad Wimpfen,74206,19.38,7398,3637,3761,382,0.0,1.0,2706.902263880467,109.5,9.163305,49.228198,-124,0.9670300452007445
5,5,66,24,24,Horstmar,48612,44.76,7382,4034,3348,165,0.0,3.0,1959.8071583030323,110.4,7.305156,52.080812,686,1.2048984468339308
14,6,25,5231,450,Pulsnitz,1896,26.76,7359,3578,3781,275,0.0,2.0,1259.0,110.3,13.96816,51.17647,-203,0.9463104998677598
16,0,71,3,3,Bad Berka,99438,55.32,7355,3551,3804,133,0.0,2.0,2301.6314266551562,110.9,11.283174,50.899497,-253,0.9334910620399579
14,5,22,510,510,Roßwein,4741,44.1,7355,3690,3665,167,0.0,2.0,1384.1013957730029,110.3,13.183633,51.065071,25,1.0068212824010914
1,0,51,5175,74,Meldorf,25704,21.26,7355,3535,3820,346,0.0,2.0,1818.5,109.4,9.144199,54.095594,-285,0.925392670157068
9,4,71,185,185,Scheßlitz,96110,94.87,7343,3700,3643,77,0.0,2.0,2389.153072733723,110.5,11.032239,49.974937,57,1.0156464452374416
15,0,82,5,5,Aken (Elbe),6385,59.79,7304,3569,3735,122,0.0,2.0,1485.579749694436,110.7,12.043952,51.852549,-166,0.9555555555555556
9,6,74,5611,130,Ebern,96106,95.01,7304,3713,3591,77,0.0,2.0,1701.0,110.5,10.793894,50.093985,122,1.0339738234475078
13,0,71,5153,92,Malchin,17139,109.28,7272,3549,3723,67,0.0,2.0,1265.5947651355164,111.0,12.68118,53.696842,-174,0.9532634971796938
6,4,40,9,9,Gedern,63688,75.24,7271,3663,3608,97,0.0,2.0,1702.5,109.8,9.19793,50.424404,55,1.0152439024390243
9,2,72,118,118,Freyung,94078,48.63,7261,3588,3673,149,0.0,2.0,2532.028072733723,110.5,13.54759,48.808968,-85,0.976858154097468
9,6,75,117,117,Dettelbach,97337,60.94,7261,3670,3591,119,0.0,2.0,2329.0,110.5,10.160342,49.801715,79,1.0219994430520747
7,3,37,5001,501,Annweiler am Trifels,76855,39.87,7254,3555,3699,182,0.0,2.0,2619.4097033712096,109.8,7.966259,49.203001,-144,0.9610705596107056
14,5,23,200,200,Markneukirchen,8258,69.04,7237,3559,3678,105,0.0,2.0,1199.4763957730029,110.3,12.328041,50.311884,-119,0.9676454594888526
12,0,64,512,512,Wriezen,16269,95.14,7221,3580,3641,76,0.0,2.0,1704.079749694436,110.7,14.134186,52.720931,-61,0.9832463608898654
7,1,34,5002,10,Birkenfeld,55765,13.64,7220,3665,3555,529,0.0,2.0,1500.5,109.8,7.168182,49.650147,110,1.030942334739803
16,0,65,87,87,Roßleben-Wiehe,6571,73.08,7219,3525,3694,99,0.0,2.0,1273.3814266551562,110.9,11.432894,51.29717,-169,0.9542501353546291
6,4,31,22,22,Zwingenberg,64673,5.66,7203,3533,3670,1273,0.0,2.0,3217.6597033712096,109.8,8.612274,49.726069,-137,0.9626702997275204
8,3,17,5004,40,Haslach im Kinzigtal,77716,18.67,7202,3558,3644,386,0.0,2.0,2579.6446879301366,109.5,8.110824,48.287203,-86,0.9763995609220637
16,0,73,5054,112,Königsee,7426,103.01,7176,3584,3592,70,0.0,2.0,1308.0,110.9,11.158647,50.655688,-8,0.9977728285077951
7,2,31,5001,8,Bernkastel-Kues,54470,23.71,7156,3470,3686,302,0.0,2.0,2239.4097033712096,109.8,7.075291,49.915468,-216,0.9413998914812806
9,5,76,122,122,Greding,91171,103.73,7148,3663,3485,69,0.0,2.0,2547.5,110.5,11.353332,49.046413,178,1.0510760401721664
16,0,67,19,19,Friedrichroda,99894,36.87,7127,3433,3694,193,0.0,2.0,2355.7564266551562,110.9,10.573924,50.860102,-261,0.929344883595019
16,0,71,5053,102,Am Ettersberg,99439,92.44,7124,3567,3557,77,0.0,2.0,2172.1314266551562,110.9,11.210999,51.051754,10,1.0028113578858588
12,0,64,317,317,Müncheberg,15374,152.29,7097,3608,3489,47,0.0,2.0,1743.0,110.7,14.140462,52.503279,119,1.0341071940384063
6,6,33,14,14,Immenhausen,34376,28.54,7092,3472,3620,248,0.0,2.0,1919.1597033712096,109.8,9.480087,51.427223,-148,0.9591160220994475
1,0,58,5864,117,Nortorf,24589,12.77,7090,3468,3622,555,0.0,2.0,2217.5,109.4,9.878799,54.178086,-154,0.9574820541137493
8,1,27,5005,43,Ilshofen,74532,54.87,7089,3627,3462,129,0.0,2.0,2437.3946879301366,109.5,9.921075,49.169825,165,1.0476603119584056
6,6,32,9,9,Heringen (Werra),36266,61.2,7080,3510,3570,116,0.0,2.0,1786.0347033712096,109.8,10.007553,50.888153,-60,0.9831932773109243
14,5,21,170,170,Eibenstock,8309,112.24,7035,3430,3605,63,0.0,2.0,1103.3513957730029,110.3,12.599287,50.493785,-175,0.9514563106796117
6,6,34,17,17,Neukirchen,34626,66.25,7026,3482,3544,106,0.0,2.0,1132.5,109.8,9.342803,50.871054,-62,0.9825056433408578
8,3,37,5001,22,Bonndorf im Schwarzwald,79848,75.91,7022,3564,3458,93,0.0,2.0,2416.0196879301366,109.5,8.343011,47.819632,106,1.0306535569693465
9,7,73,5716,139,Höchstädt a.d.Donau,89420,37.45,7014,3487,3527,187,0.0,2.0,2220.278072733723,110.5,10.567234,48.611681,-40,0.9886589169265665
14,5,23,170,170,Lengenfeld,8485,46.98,7013,3423,3590,149,0.0,2.0,947.0,110.3,12.36572,50.569303,-167,0.9534818941504178
9,2,78,123,123,Geiselhöring,94333,99.69,7005,3568,3437,70,0.0,2.0,2457.278072733723,110.5,12.393582,48.826135,131,1.038114634855979
8,4,25,5003,28,Dietenheim,89165,18.75,7003,3506,3497,373,0.0,2.0,2687.8946879301366,109.5,10.069592,48.212211,9,1.0025736345438947
9,4,74,5420,121,Ebermannstadt,91320,49.95,7000,3469,3531,140,0.0,2.0,2641.0,110.5,11.184751,49.779227,-62,0.9824412347776834
3,1,55,9,9,Moringen,37186,82.39,6988,3620,3368,85,0.0,2.0,2040.8363803319298,110.0,9.871075,51.697192,252,1.0748218527315914
7,1,37,5002,89,Polch,56751,28.68,6976,3486,3490,243,0.0,2.0,1938.0,109.8,7.277285,50.283358,-4,0.9988538681948425
8,4,25,108,108,Schelklingen,89601,75.87,6959,3586,3373,92,0.0,2.0,2527.7696879301366,109.5,9.734923,48.372526,213,1.0631485324636822
6,4,40,21,21,Reichelsheim (Wetterau),61203,27.56,6955,3468,3487,252,0.0,2.0,2338.1597033712096,109.8,8.874689,50.358447,-19,0.9945511901347863
16,0,61,118,118,Dingelstädt,37351,59.39,6935,3446,3489,117,0.0,2.0,1610.8814266551562,110.9,10.314844,51.315205,-43,0.9876755517340212
7,3,39,5003,19,Gau-Algesheim,55435,13.99,6935,3346,3589,496,0.0,2.0,3432.0,109.8,8.01497,49.957647,-243,0.9322931178601281
13,0,76,5660,105,Neustadt-Glewe,19306,94.05,6931,3450,3481,74,0.0,2.0,1330.9697651355164,111.0,11.660515,53.362153,-31,0.9910945130709566
15,0,89,175,175,Hecklingen,39444,95.34,6893,3376,3517,72,0.0,2.0,939.5,110.7,11.533566,51.847482,-141,0.9599090133636622
9,4,75,168,168,Schwarzenbach a.d.Saale,95126,59.18,6878,3387,3491,116,0.0,2.0,2466.278072733723,110.5,11.938077,50.221068,-104,0.9702091091377829
14,6,27,50,50,Gröditz,1609,28.94,6877,3427,3450,238,0.0,2.0,1175.4763957730029,110.3,13.447811,51.412323,-23,0.9933333333333333
9,6,78,5642,134,Gerolzhofen,97447,18.39,6860,3364,3496,373,0.0,2.0,2072.0,110.5,10.313963,49.887039,-132,0.9622425629290617
6,6,35,21,21,Waldeck,34513,115.7,6810,3396,3414,59,0.0,2.0,1698.5347033712096,109.8,9.061733,51.20664,-18,0.9947275922671354
16,0,74,44,44,Kahla,7768,7.9,6806,3341,3465,862,0.0,2.0,2029.0064266551562,110.9,11.588507,50.801709,-124,0.9642135642135642
14,7,29,150,150,Geithain,4643,54.71,6797,3319,3478,124,0.0,2.0,1173.0,110.3,12.695256,51.05415,-159,0.9542840713053479
15,0,81,30,30,Arendsee (Altmark),39619,269.55,6797,3396,3401,25,0.0,2.0,1584.954749694436,110.7,11.489149,52.881825,-5,0.9985298441634813
15,0,87,165,165,Gerbstedt,6347,102.31,6790,3398,3392,66,0.0,2.0,1511.204749694436,110.7,11.625691,51.633084,6,1.0017688679245282
15,0,86,80,80,Jerichow,39319,270.06,6786,3439,3347,25,0.0,2.0,1220.5,110.7,12.024965,52.49836,92,1.0274873020615476
14,5,22,250,250,Hartha,4746,54.4,6777,3339,3438,125,0.0,2.0,1210.1013957730029,110.3,12.977781,51.097507,-99,0.9712041884816754
14,7,29,40,40,Böhlen,4564,25.27,6776,3311,3465,268,0.0,2.0,1206.3513957730029,110.3,12.387241,51.202806,-154,0.9555555555555556
6,6,35,20,20,Volkmarsen,34471,67.47,6769,3394,3375,100,0.0,2.0,1339.0,109.8,9.114575,51.412606,19,1.0056296296296297
9,3,71,156,156,Vilseck,92249,64.69,6768,3373,3395,105,0.0,2.0,2429.028072733723,110.5,11.805301,49.611105,-22,0.993519882179676
9,5,75,5519,168,Uffenheim,97215,59.47,6739,3362,3377,113,0.0,2.0,2189.0,110.5,10.12469,49.531539,-15,0.9955581877405981
12,0,63,148,148,Ketzin/Havel,14669,93.64,6726,3302,3424,72,0.0,2.0,1491.329749694436,110.7,12.843529,52.477436,-122,0.9643691588785047
8,2,25,5007,75,Osterburken,74706,47.32,6715,3388,3327,142,0.0,2.0,2422.7696879301366,109.5,9.426233,49.428346,61,1.0183348361887588
8,1,26,5001,58,Neuenstein,74632,47.84,6705,3384,3321,140,0.0,2.0,2786.0,109.5,9.582072,49.205319,63,1.018970189701897
9,3,72,171,171,Waldmünchen,93449,101.17,6700,3337,3363,66,0.0,2.0,2393.528072733723,110.5,12.70563,49.375825,-26,0.992268807612251
8,1,28,5002,14,Boxberg,97944,101.71,6698,3433,3265,66,0.0,2.0,2585.2696879301366,109.5,9.641258,49.481118,168,1.0514548238897397
9,6,72,113,113,Bad Brückenau,97769,23.71,6695,3278,3417,282,0.0,2.0,1659.0,110.5,9.786819,50.309455,-139,0.9593210418495757
16,0,74,5050,94,Stadtroda,7646,24.18,6695,3236,3459,277,0.0,2.0,1452.0064266551562,110.9,11.773768,50.799841,-223,0.9355305001445504
7,3,37,5003,20,Edenkoben,67480,17.89,6693,3376,3317,374,0.0,2.0,3093.0,109.8,8.127001,49.282672,59,1.0177871570696413
7,3,40,5004,38,Rodalben,66976,15.69,6675,3251,3424,425,0.0,2.0,2514.0347033712096,109.8,7.638519,49.239307,-173,0.9494742990654206
16,0,69,62,62,Römhild,98630,122.45,6661,3377,3284,54,0.0,2.0,2172.8814266551562,110.9,10.538723,50.396867,93,1.0283191230207065
14,6,28,130,130,Glashütte,1768,95.64,6657,3365,3292,70,0.0,2.0,1343.0,110.3,13.781215,50.851929,73,1.0221749696233293
16,0,68,63,63,Buttstädt,99628,104.8,6651,3363,3288,63,0.0,2.0,2200.3814266551562,110.9,11.419701,51.122402,75,1.022810218978102
7,1,32,5003,50,Herdorf,57562,17.99,6651,3287,3364,370,0.0,2.0,2401.6597033712096,109.8,7.949645,50.778162,-77,0.9771105826397146
16,0,65,5055,86,Artern,6556,45.05,6635,3253,3382,147,0.0,2.0,958.5,110.9,11.228178,51.396425,-129,0.9618568894145476
9,3,77,158,158,Waldsassen,95652,66.53,6628,3243,3385,100,0.0,2.0,2505.528072733723,110.5,12.30533,50.003499,-142,0.9580502215657312
8,2,36,5003,38,Maulbronn,75433,25.4,6622,3337,3285,261,0.0,2.0,2897.0,109.5,8.814618,49.000362,52,1.0158295281582952
16,0,71,8,8,Blankenhain,99444,113.75,6616,3281,3335,58,0.0,2.0,2183.7564266551562,110.9,11.343008,50.859577,-54,0.983808095952024
3,2,57,5406,32,Rodenberg,31552,15.61,6612,3320,3292,424,0.0,2.0,1915.5,110.0,9.336445,52.289576,28,1.008505467800729
9,4,73,158,158,Bad Rodach,96476,77.65,6606,3264,3342,85,0.0,2.0,2419.653072733723,110.5,10.778713,50.341213,-78,0.9766606822262118
6,6,33,29,29,Zierenberg,34289,86.55,6604,3266,3338,76,0.0,2.0,1665.5,109.8,9.300261,51.367615,-72,0.9784301977231875
9,3,77,5347,141,Mitterteich,95666,39.38,6599,3217,3382,168,0.0,2.0,2482.903072733723,110.5,12.28501,49.946542,-165,0.9512123004139562
9,3,74,124,124,Grafenwöhr,92655,216.21,6567,3176,3391,30,0.0,2.0,1905.5,110.5,11.90618,49.720869,-215,0.9365968740784429
7,1,32,5010,501,Altenkirchen (Westerwald),57610,10.98,6564,3129,3435,598,0.0,2.0,2858.7847033712096,109.8,7.628807,50.674542,-306,0.9109170305676856
14,7,29,5308,350,Pegau,4523,48.77,6561,3224,3337,135,0.0,2.0,1142.1013957730029,110.3,12.2391,51.147289,-113,0.9661372490260713
13,0,72,5257,62,Laage,18299,114.9,6549,3264,3285,57,0.0,2.0,1246.4697651355164,111.0,12.214155,53.947182,-21,0.993607305936073
8,4,17,54,54,Rosenfeld,72348,51.11,6547,3306,3241,128,0.0,2.0,2145.5,109.5,8.723243,48.286301,65,1.0200555384140697
13,0,71,5154,93,Malchow,17213,44.71,6543,3154,3389,146,0.0,2.0,1390.5947651355164,111.0,12.392639,53.389037,-235,0.9306580112127472
16,0,68,34,34,Kölleda,99625,89.52,6526,3288,3238,73,0.0,2.0,1500.0,110.9,11.249169,51.18884,50,1.015441630636195
14,7,29,370,370,Rötha,4571,45.41,6516,3333,3183,143,0.0,2.0,1240.8513957730029,110.3,12.414903,51.198128,150,1.0471253534401508
15,0,91,10,10,Annaburg,6925,225.63,6514,3236,3278,29,0.0,2.0,960.5,110.7,13.046683,51.731338,-42,0.9871873093349604
7,1,33,5010,501,Bad Sobernheim,55566,54.18,6495,3188,3307,120,0.0,2.0,2389.0347033712096,109.8,7.634404,49.846349,-119,0.9640157242213486
9,1,83,5149,129,Neumarkt-Sankt Veit,84494,61.07,6494,3260,3234,106,0.0,2.0,2407.778072733723,110.5,12.508258,48.361946,26,1.008039579468151
13,0,71,5152,35,Friedland,17098,141.79,6478,3162,3316,46,0.0,2.0,1588.0,111.0,13.553318,53.670639,-154,0.9535585042219542
9,4,78,116,116,Burgkunstadt,96224,40.6,6470,3119,3351,159,0.0,2.0,2528.653072733723,110.5,11.249566,50.142232,-232,0.930766935243211
7,3,36,5010,55,Kusel,66869,14.37,6470,3553,2917,450,0.0,2.0,1574.5,109.8,7.396821,49.557294,636,1.2180322248885842
9,7,74,5732,185,Thannhausen,86470,20.03,6469,3211,3258,323,0.0,2.0,2352.028072733723,110.5,10.470124,48.282534,-47,0.985573971761817
8,1,25,5010,38,Güglingen,74363,16.27,6467,3272,3195,397,0.0,2.0,2881.0,109.5,8.99847,49.066703,77,1.0241001564945227
15,0,90,225,225,Havelberg,39539,149.26,6465,3176,3289,43,0.0,2.0,1862.579749694436,110.7,12.073338,52.824884,-113,0.9656430525995744
8,3,15,5006,50,Heitersheim,79423,11.71,6465,3199,3266,552,0.0,2.0,3784.0,109.5,7.664915,47.871917,-67,0.9794856093080221
14,5,23,360,360,Rodewisch,8228,26.88,6451,3123,3328,240,0.0,2.0,1437.6013957730029,110.3,12.403374,50.531885,-205,0.9384014423076923
8,3,27,5003,18,Geisingen,78187,73.75,6441,3258,3183,87,0.0,2.0,2329.5196879301366,109.5,8.650319,47.922537,75,1.0235626767200754
7,1,38,5004,41,Linz am Rhein,53545,17.98,6412,3102,3310,357,0.0,2.0,2500.0,109.8,7.282754,50.568845,-208,0.9371601208459215
13,0,76,5666,152,Wittenburg,19243,80.08,6400,3220,3180,80,0.0,2.0,1368.8447651355164,111.0,11.074364,53.511635,40,1.0125786163522013
1,0,59,113,113,Glücksburg (Ostsee),24960,39.68,6377,3070,3307,161,0.0,2.0,2493.056349449769,109.4,9.550997,54.836858,-237,0.9283338373147868
8,1,16,5004,46,Neuffen,72639,17.43,6322,3172,3150,363,0.0,2.0,3446.5,109.5,9.37432,48.555671,22,1.006984126984127
8,4,37,5001,31,Gammertingen,72501,52.97,6318,3233,3085,119,0.0,2.0,2338.7696879301366,109.5,9.2157,48.250288,148,1.0479740680713128
9,5,71,214,214,Wassertrüdingen,91717,53.57,6309,3186,3123,118,0.0,2.0,2150.5,110.5,10.59722,49.041141,63,1.0201729106628241
16,0,63,103,103,Werra-Suhl-Tal,99837,77.67,6288,3185,3103,81,0.0,2.0,2228.1314266551562,110.9,10.068487,50.939304,82,1.02642603931679
9,3,76,5341,144,Nabburg,92507,62.36,6281,3126,3155,101,0.0,2.0,2362.278072733723,110.5,12.179641,49.451719,-29,0.9908082408874802
14,6,25,30,30,Bernsdorf,2994,59.86,6280,3105,3175,105,0.0,2.0,1124.5,110.3,14.0695,51.376325,-70,0.9779527559055118
8,3,36,5009,103,Zell im Wiesental,79669,36.12,6279,3134,3145,174,0.0,2.0,2559.2696879301366,109.5,7.852117,47.707567,-11,0.9965023847376788
8,4,15,73,73,Trochtelfingen,72818,79.2,6277,3159,3118,79,0.0,2.0,2293.0,109.5,9.246991,48.308771,41,1.0131494547787043
9,6,76,134,134,Klingenberg a.Main,63911,21.13,6270,3075,3195,297,0.0,2.0,2224.403072733723,110.5,9.183177,49.783497,-120,0.9624413145539906
12,0,62,5031,128,Falkenberg/Elster,4895,82.16,6263,3102,3161,76,0.0,2.0,1290.829749694436,110.7,13.236202,51.587007,-59,0.981335020563113
6,6,36,4,4,Großalmerode,37247,37.59,6255,3101,3154,166,0.0,2.0,1127.5,109.8,9.784493,51.257737,-53,0.9831959416613824
14,6,28,5209,80,Dohna,1809,28.59,6249,3123,3126,219,0.0,2.0,1089.4763957730029,110.3,13.863536,50.980894,-3,0.9990403071017274
8,3,15,133,133,Vogtsburg im Kaiserstuhl,79235,37.36,6242,3186,3056,167,0.0,2.0,2509.3946879301366,109.5,7.629966,48.088977,130,1.0425392670157068
7,1,43,5001,206,Bad Marienberg (Westerwald),56470,9.95,6238,3074,3164,627,0.0,2.0,2774.7847033712096,109.8,7.950685,50.651469,-90,0.9715549936788875
8,3,25,12,12,Dornhan,72175,44.91,6238,3108,3130,139,0.0,2.0,2133.0,109.5,8.510397,48.350916,-22,0.9929712460063898
13,0,76,5663,114,Plau am See,19395,116.27,6231,3036,3195,54,0.0,2.0,1308.2197651355164,111.0,12.210565,53.496939,-159,0.9502347417840376
9,5,71,226,226,Windsbach,91575,68.12,6225,3173,3052,91,0.0,2.0,2350.403072733723,110.5,10.830957,49.249157,121,1.0396461336828309
7,1,43,5002,229,Hachenburg,57627,21.43,6223,2952,3271,290,0.0,2.0,1802.0,109.8,7.779931,50.691957,-319,0.9024763069397738
8,1,25,5012,8,Beilstein,71717,25.24,6210,3099,3111,246,0.0,2.0,2509.2696879301366,109.5,9.313798,49.040994,-12,0.996142719382835
9,3,73,121,121,Dietfurt a.d.Altmühl,92345,78.7,6208,3235,2973,79,0.0,2.0,2378.028072733723,110.5,11.587369,49.034947,262,1.0881264715775312
9,2,73,164,164,Riedenburg,93339,100.3,6206,3125,3081,62,0.0,2.0,2536.5,110.5,11.691777,48.96267,44,1.0142810775722169
13,0,76,5655,89,Lübz,19386,74.69,6183,2959,3224,83,0.0,2.0,1358.4697651355164,111.0,12.168335,53.501509,-265,0.917803970223325
8,2,37,2,2,Alpirsbach,72275,64.56,6177,3185,2992,96,0.0,2.0,1831.5,109.5,8.402938,48.345111,193,1.0645053475935828
5,7,62,28,28,Nieheim,33039,79.71,6157,3179,2978,77,0.0,3.0,1604.0571583030323,110.4,9.110021,51.804067,201,1.067494963062458
8,4,35,5004,36,Meersburg,88709,12.07,6142,2915,3227,509,0.0,2.0,2890.8946879301366,109.5,9.320022,47.67625,-312,0.9033157731639293
9,4,71,220,220,Schlüsselfeld,96132,70.24,6137,3193,2944,87,0.0,2.0,2096.0,110.5,10.619344,49.756792,249,1.0845788043478262
7,1,38,5002,4,Bad Hönningen,53557,20.09,6133,2982,3151,305,0.0,2.0,2320.7847033712096,109.8,7.306432,50.515502,-169,0.9463662329419232
6,6,34,24,24,Spangenberg,34286,97.71,6122,3107,3015,63,0.0,2.0,1728.5,109.8,9.65858,51.116895,92,1.030514096185738
9,6,73,141,141,Bad Königshofen i.Grabfeld,97631,69.51,6113,2988,3125,88,0.0,2.0,2348.528072733723,110.5,10.467271,50.299384,-137,0.95616
12,0,60,5003,24,Biesenthal,16359,60.92,6079,3011,3068,100,0.0,2.0,2865.5,110.7,13.63123,52.765802,-57,0.9814211212516297
14,6,25,525,525,Schirgiswalde-Kirschau,2681,24.34,6057,3035,3022,249,0.0,2.0,1434.3513957730029,110.3,14.428566,51.092621,13,1.0043017868960953
12,0,65,5502,100,Gransee,16775,121.68,6046,2953,3093,50,0.0,2.0,2962.5,110.7,13.153342,52.89704,-140,0.9547365017782089
1,0,51,5166,72,Marne,25709,4.83,6037,2871,3166,1250,0.0,2.0,3301.681349449769,109.4,9.023165,53.946249,-295,0.906822488945041
16,0,73,5,5,Bad Blankenburg,7422,35.62,6029,3014,3015,169,0.0,3.0,1355.5,110.9,11.261585,50.68475,-1,0.9996683250414594
8,3,26,5001,6,Bräunlingen,78199,62.14,6014,3044,2970,97,0.0,1.0,2289.027263880467,109.5,8.448829,47.930249,74,1.024915824915825
8,2,35,5007,32,Haiterbach,72221,28.92,6005,3041,2964,208,0.0,2.0,2431.0,109.5,8.649992,48.524432,77,1.025978407557355
9,3,74,139,139,Neustadt a.d.Waldnaab,92660,9.93,6001,2960,3041,604,0.0,2.0,2920.778072733723,110.5,12.175697,49.732495,-81,0.973364024991779
3,4,52,20,20,Norderney,26548,26.31,5992,2812,3180,228,0.0,2.0,1982.4613803319298,110.0,7.145431,53.707276,-368,0.8842767295597485
7,1,38,5003,12,Dierdorf,56269,31.98,5977,2965,3012,187,0.0,2.0,1840.5,109.8,7.6595,50.547979,-47,0.9843957503320053
16,0,65,5056,88,An der Schmücke,6577,95.28,5973,2975,2998,63,0.0,2.0,1128.2564266551562,110.9,11.175971,51.262443,-23,0.9923282188125417
15,0,89,235,235,Nienburg (Saale),6429,79.32,5966,2980,2986,75,0.0,2.0,1589.204749694436,110.7,11.766344,51.836428,-6,0.9979906229068989
8,4,17,5002,22,Geislingen,72351,31.96,5957,2972,2985,186,0.0,2.0,2284.2696879301366,109.5,8.811353,48.287956,-13,0.995644891122278
16,0,70,58,58,Großbreitenbach,98701,80.76,5956,2984,2972,74,0.0,2.0,1066.0,110.9,11.013059,50.584346,12,1.0040376850605652
14,5,21,620,620,Thalheim/Erzgeb.,9380,10.79,5948,2837,3111,551,0.0,2.0,1856.8513957730029,110.3,12.849866,50.701048,-274,0.9119254259080681
8,1,27,75,75,Schrozberg,74575,105.21,5908,3051,2857,56,0.0,2.0,1937.0,109.5,9.979876,49.344875,194,1.0679033951697585
16,0,64,5055,77,Nottertal-Heilinger Höhen,99994,75.96,5899,3084,2815,78,0.0,2.0,2121.6314266551562,110.9,10.679916,51.230695,269,1.0955595026642984
7,1,43,5009,308,Westerburg,56457,18.48,5883,2857,3026,318,0.0,2.0,2561.0347033712096,109.8,7.962362,50.590281,-169,0.9441506939854594
9,1,89,152,152,Tittmoning,84529,72.01,5868,2944,2924,81,0.0,2.0,2521.778072733723,110.5,12.768954,48.060438,20,1.0068399452804377
14,6,26,180,180,Herrnhut,2747,74.13,5849,2893,2956,79,0.0,2.0,743.5,110.3,14.74397,51.015492,-63,0.9786874154262517
16,0,63,76,76,Treffurt,99830,72.46,5834,2939,2895,81,0.0,2.0,2220.2564266551562,110.9,10.230207,51.137051,44,1.0151986183074266
6,4,40,15,15,Münzenberg,35516,31.63,5832,2857,2975,184,0.0,2.0,2443.5,109.8,8.777495,50.45595,-118,0.9603361344537815
14,5,24,230,230,Oberlungwitz,9353,14.68,5827,2830,2997,397,0.0,2.0,1531.6013957730029,110.3,12.722076,50.786972,-167,0.9442776109442776
12,0,65,84,84,Fürstenberg/Havel,16798,213.85,5816,2840,2976,27,0.0,2.0,1359.329749694436,110.7,13.145303,53.184686,-136,0.9543010752688172
6,5,32,16,16,Leun,35638,28.66,5813,2876,2937,203,0.0,2.0,1749.5,109.8,8.357168,50.549638,-61,0.979230507320395
16,0,66,74,74,Brotterode-Trusetal,98596,49.68,5810,2847,2963,117,0.0,2.0,2282.7564266551562,110.9,10.40787,50.786201,-116,0.9608504893688828
13,0,71,5162,142,Stavenhagen,17153,41.02,5803,2891,2912,141,0.0,2.0,1133.5,111.0,12.955089,53.600889,-21,0.9927884615384616
8,2,35,5005,47,Neubulach,75387,24.69,5796,2888,2908,235,0.0,2.0,2582.8946879301366,109.5,8.692017,48.661372,-20,0.9931224209078404
16,0,65,89,89,Greußen,99718,86.82,5793,2908,2885,67,0.0,2.0,1291.0,110.9,10.944013,51.228102,23,1.0079722703639515
14,7,30,200,200,Mügeln,4769,55.08,5792,2894,2898,105,0.0,2.0,1127.9763957730029,110.3,13.046003,51.236779,-4,0.9986197377501725
6,6,33,10,10,Grebenstein,34393,49.84,5790,2875,2915,116,0.0,2.0,1782.5347033712096,109.8,9.414625,51.446845,-40,0.9862778730703259
8,3,17,5005,41,Hausach,77756,36.07,5788,2875,2913,160,0.0,2.0,2768.5,109.5,8.171188,48.28416,-38,0.98695502917954
9,7,79,5723,228,Wemding,86650,31.6,5781,2815,2966,183,0.0,2.0,2285.778072733723,110.5,10.724374,48.872377,-151,0.9490896830748483
7,2,31,5009,124,Traben-Trarbach,56841,31.35,5748,2836,2912,183,0.0,2.0,1698.0,109.8,7.116738,49.951356,-76,0.9739010989010989
1,0,54,5494,19,Bredstedt,25821,9.75,5736,2806,2930,588,0.0,2.0,2706.556349449769,109.4,8.883096,54.620428,-124,0.957679180887372
16,0,75,62,62,Bad Lobenstein,7356,48.92,5733,2809,2924,117,0.0,2.0,1174.0,110.9,11.640388,50.450309,-115,0.9606703146374829
7,1,40,5003,64,Kastellaun,56288,8.41,5732,2820,2912,682,0.0,2.0,2725.4097033712096,109.8,7.465531,50.031246,-92,0.9684065934065934
8,2,26,5009,91,Waibstadt,74915,25.57,5728,2801,2927,224,0.0,2.0,2538.0196879301366,109.5,8.920252,49.299852,-126,0.956952511103519
3,2,55,5409,34,Stadtoldendorf,37627,24.92,5726,2852,2874,230,0.0,2.0,989.5,110.0,9.569322,51.866505,-22,0.9923451635351427
16,0,66,5005,95,Kaltennordheim,36452,94.41,5716,2913,2803,61,0.0,2.0,1449.5064266551562,110.9,10.098294,50.664091,110,1.0392436674991081
14,5,21,260,260,Grünhain-Beierfeld,8344,22.25,5712,2844,2868,257,0.0,2.0,808.5,110.3,12.787358,50.561375,-24,0.9916317991631799
8,3,17,5013,145,Wolfach,77709,67.98,5688,2814,2874,84,0.0,2.0,2336.8946879301366,109.5,8.216772,48.317073,-60,0.9791231732776617
14,5,22,5126,490,Rochlitz,9306,23.76,5688,2700,2988,239,0.0,2.0,1137.0,110.3,12.931193,51.006513,-288,0.9036144578313253
14,6,25,640,640,Wittichenau / Kulow,2997,61.02,5686,2762,2924,93,0.0,2.0,1342.8513957730029,110.3,14.243586,51.385325,-162,0.9445964432284542
12,0,66,296,296,Schwarzheide,1987,33.44,5681,2835,2846,170,0.0,2.0,1582.079749694436,110.7,13.854253,51.478084,-11,0.9961349262122277
9,5,71,174,174,Leutershausen,91578,84.07,5669,2817,2852,67,0.0,2.0,2067.5,110.5,10.410982,49.29788,-35,0.9877279102384292
9,6,74,221,221,Zeil a.Main,97475,35.67,5662,2807,2855,159,0.0,2.0,2479.653072733723,110.5,10.595267,50.008547,-48,0.9831873905429072
3,1,58,5407,27,Schöppenstedt,38170,39.74,5653,2784,2869,142,0.0,2.0,2082.46138033193,110.0,10.8491,52.140229,-85,0.9703729522481701
9,3,71,127,127,Hirschau,92242,74.96,5643,2750,2893,75,0.0,2.0,1994.5,110.5,11.942747,49.544228,-143,0.9505703422053232
7,1,43,5010,81,Wirges,56422,10.11,5641,2783,2858,558,0.0,2.0,2646.5347033712096,109.8,7.796234,50.471632,-75,0.9737578726382086
3,2,55,5408,3,Bodenwerder,37619,29.05,5634,2728,2906,194,0.0,2.0,2058.21138033193,110.0,9.515591,51.977346,-178,0.9387474191328287
12,0,64,448,448,Seelow,15306,42.73,5628,2666,2962,132,0.0,2.0,1522.5,110.7,14.381058,52.533809,-296,0.900067521944632
9,6,73,5633,142,Mellrichstadt,97638,55.99,5622,2758,2864,100,0.0,2.0,2268.903072733723,110.5,10.308184,50.428478,-106,0.9629888268156425
9,3,77,5348,129,Kemnath,95478,56.79,5622,2794,2828,99,0.0,2.0,2395.653072733723,110.5,11.887026,49.870144,-34,0.987977369165488
13,0,76,5657,50,Grabow,19300,72.27,5615,2775,2840,78,0.0,2.0,1251.0,111.0,11.717229,53.262969,-65,0.977112676056338
9,7,79,155,155,Harburg (Schwaben),86655,73.16,5612,2819,2793,77,0.0,2.0,2215.278072733723,110.5,10.692591,48.786821,26,1.0093089867525957
9,5,76,111,111,Abenberg,91183,48.41,5607,2749,2858,116,0.0,2.0,2367.778072733723,110.5,10.963645,49.241703,-109,0.9618614415675297
3,1,53,16,16,Braunlage,38700,31.65,5585,2794,2791,176,0.0,2.0,1190.5,110.0,10.610704,51.728022,3,1.0010748835542815
6,6,34,18,18,Niedenstein,34305,30.61,5577,2812,2765,182,0.0,2.0,1860.5347033712096,109.8,9.312719,51.235739,47,1.0169981916817359
8,1,25,68,68,Neudenau,74861,32.91,5561,2814,2747,169,0.0,2.0,2243.0,109.5,9.270659,49.292642,67,1.024390243902439
14,6,28,380,380,Stolpen,1833,60.89,5559,2790,2769,91,0.0,2.0,1203.7263957730029,110.3,14.000685,51.029346,21,1.0075839653304441
8,2,36,5001,25,Heimsheim,71296,14.3,5553,2948,2605,388,0.0,2.0,3876.5,109.5,8.863456,48.805183,343,1.1316698656429942
14,6,28,5202,20,Bad Gottleuba-Berggießhübel,1816,88.72,5541,2764,2777,62,0.0,2.0,874.7263957730029,110.3,13.943289,50.851891,-13,0.9953186892329853
7,2,32,5006,296,Prüm,54595,22.86,5536,2805,2731,242,0.0,2.0,2339.4097033712096,109.8,6.471015,50.229984,74,1.0270963017209813
8,3,37,106,106,Stühlingen,79780,93.2,5527,2819,2708,59,0.0,2.0,2348.0,109.5,8.445849,47.745475,111,1.0409896602658788
7,3,34,5002,8,Hagenbach,76767,15.86,5518,2721,2797,348,0.0,2.0,2492.5347033712096,109.8,8.247027,49.02038,-76,0.9728280300321773
6,6,31,10,10,Gersfeld (Rhön),36129,89.34,5516,2739,2777,62,0.0,2.0,1709.6597033712096,109.8,9.920598,50.45036,-38,0.9863161685271876
12,0,71,57,57,Drebkau/Drjowk,3116,143.9,5511,2781,2730,38,0.0,2.0,1296.329749694436,110.7,14.217333,51.657264,51,1.0186813186813186
14,5,22,210,210,Großschirma,9603,61.63,5502,2744,2758,89,0.0,2.0,997.0,110.3,13.276907,50.966191,-14,0.9949238578680203
6,6,35,4,4,Battenberg (Eder),35088,64.71,5500,2788,2712,85,0.0,2.0,1755.7847033712096,109.8,8.647673,51.013769,76,1.028023598820059
16,0,62,5,5,Ellrich,99755,69.41,5492,2700,2792,79,0.0,2.0,935.0,110.9,10.665677,51.587555,-92,0.9670487106017192
13,0,76,5667,159,Zarrentin am Schaalsee,19246,91.9,5484,2755,2729,60,0.0,1.0,1301.477341085847,111.0,10.943267,53.499281,26,1.0095272993770612
9,3,73,167,167,Velburg,92355,175.66,5478,2777,2701,31,0.0,2.0,2292.278072733723,110.5,11.670239,49.231086,76,1.0281377267678637
9,7,79,5724,186,Monheim,86653,69.33,5476,2805,2671,79,0.0,2.0,2405.5,110.5,10.904183,48.791856,134,1.0501684762261325
9,6,74,133,133,Eltmann,97483,40.81,5473,2760,2713,134,0.0,2.0,2403.778072733723,110.5,10.664635,49.971589,47,1.0173239955768523
14,6,28,5240,400,Tharandt,1737,71.23,5471,2735,2736,77,0.0,2.0,1959.0,110.3,13.580901,50.98597,-1,0.9996345029239766
8,1,26,5003,39,Ingelfingen,74653,46.48,5467,2714,2753,118,0.0,2.0,2438.7696879301366,109.5,9.654049,49.299402,-39,0.9858336360334181
13,0,74,5452,21,Gadebusch,19205,47.76,5457,2644,2813,114,0.0,2.0,1354.7197651355164,111.0,11.224446,53.70775,-169,0.9399217916814788
1,0,57,5727,48,Lütjenburg,24321,6.15,5443,2563,2880,885,0.0,2.0,2989.556349449769,109.4,10.603736,54.346515,-317,0.8899305555555556
16,0,66,5013,86,Wasungen,98634,89.08,5437,2737,2700,61,0.0,2.0,1021.5,110.9,10.047106,50.529421,37,1.0137037037037038
9,7,79,5721,197,Oettingen i.Bay.,86732,34.22,5427,2723,2704,159,0.0,2.0,2239.153072733723,110.5,10.605363,48.955274,19,1.007026627218935
7,3,35,5010,35,Otterberg,67697,32.11,5425,2614,2811,169,0.0,2.0,2112.5,109.8,7.772375,49.502037,-197,0.9299181785841337
6,4,31,15,15,Lindenfels,64678,21.09,5411,2597,2814,257,0.0,2.0,2333.5347033712096,109.8,8.77983,49.68301,-217,0.9228855721393034
7,3,33,5007,502,Rockenhausen,67806,36.83,5397,2680,2717,147,0.0,1.0,1602.0,109.8,7.749041,49.646631,-37,0.986382039013618
8,4,25,5010,81,Munderkingen,89597,13.07,5380,2672,2708,412,0.0,2.0,2762.5196879301366,109.5,9.624615,48.211503,-36,0.9867060561299852
8,3,17,5002,73,Mahlberg,77972,16.59,5361,2654,2707,323,0.0,2.0,2897.0,109.5,7.809923,48.288279,-53,0.9804211304026598
6,6,35,8,8,Diemelstadt,34474,82.55,5354,2680,2674,65,0.0,2.0,1723.1597033712096,109.8,9.011005,51.473285,6,1.0022438294689604
8,1,28,64,64,Külsheim,97900,81.43,5321,2725,2596,65,0.0,2.0,1685.0,109.5,9.517596,49.670835,129,1.0496918335901386
16,0,74,5015,11,Dornburg-Camburg,7774,30.77,5307,2580,2727,172,0.0,2.0,1311.1314266551562,110.9,11.71095,51.05398,-147,0.9460946094609461
7,3,36,5009,102,Waldmohr,66914,13.03,5302,2573,2729,407,0.0,2.0,2508.6597033712096,109.8,7.332884,49.387069,-156,0.9428362037376329
13,0,71,5161,21,Burg Stargard,17094,76.61,5289,2585,2704,69,0.0,2.0,1506.0,111.0,13.310132,53.495316,-119,0.955991124260355
7,1,35,5001,20,Cochem,56812,21.18,5288,2663,2625,250,0.0,2.0,2286.9097033712096,109.8,7.16384,50.144672,38,1.0144761904761905
9,3,76,5343,153,Pfreimd,92536,51.48,5286,2603,2683,103,0.0,2.0,1742.5,110.5,12.181982,49.494048,-80,0.9701826313827805
8,1,26,5004,28,Forchtenberg,74670,38.09,5285,2727,2558,139,0.0,2.0,2447.8946879301366,109.5,9.562246,49.287249,169,1.0660672400312745
16,0,63,5057,66,Ruhla,99842,38.55,5273,2593,2680,137,0.0,2.0,1271.5,110.9,10.365621,50.892673,-87,0.9675373134328358
9,4,72,179,179,Pottenstein,91278,73.29,5263,2676,2587,72,0.0,2.0,2354.528072733723,110.5,11.408159,49.770946,89,1.0344027831465017
13,0,71,5163,4,Altentreptow,17087,53.07,5263,2610,2653,99,0.0,2.0,1285.7197651355164,111.0,13.250181,53.692774,-43,0.9837919336600075
8,2,25,5009,1,Adelsheim,74740,43.84,5255,2803,2452,120,0.0,2.0,1743.5,109.5,9.391601,49.401957,351,1.1431484502446982
9,5,76,147,147,Spalt,91174,55.67,5204,2623,2581,93,0.0,2.0,2353.778072733723,110.5,10.92494,49.176045,42,1.0162727624951569
3,4,54,5402,12,Freren,49832,48.97,5196,2614,2582,106,0.0,2.0,1484.0,110.0,7.570871,52.508973,32,1.0123934934159566
14,7,29,220,220,Kitzscher,4567,29.04,5182,2530,2652,178,0.0,2.0,1219.7263957730029,110.3,12.554765,51.160292,-122,0.9539969834087482
3,4,57,2,2,Borkum,26757,30.98,5171,2473,2698,167,0.0,2.0,6666.5,110.0,6.664597,53.588001,-225,0.9166048925129726
12,0,62,5031,500,Uebigau-Wahrenbrück,4938,135.61,5159,2614,2545,38,0.0,2.0,1411.704749694436,110.7,13.299497,51.59403,69,1.0271119842829077
15,0,85,110,110,Falkenstein/Harz,6463,102.97,5120,2593,2527,50,0.0,2.0,1454.704749694436,110.7,11.343918,51.732029,66,1.0261179263949347
9,6,74,5612,149,Hofheim i.UFr.,97461,56.34,5116,2525,2591,91,0.0,2.0,2268.153072733723,110.5,10.522104,50.137398,-66,0.974527209571594
6,6,33,18,18,Naumburg,34311,66.32,5111,2515,2596,77,0.0,2.0,1201.0,109.8,9.164889,51.247294,-81,0.9687981510015409
3,3,54,5406,9,Hitzacker (Elbe),29456,58.67,5107,2393,2714,87,0.0,2.0,1816.5863803319298,110.0,11.0472,53.151971,-321,0.8817243920412675
9,3,77,116,116,Erbendorf,92681,67.56,5098,2529,2569,75,0.0,2.0,1782.0,110.5,12.048098,49.838063,-40,0.9844297391981316
13,0,71,5159,124,Röbel/Müritz,17207,30.68,5075,2431,2644,165,0.0,2.0,1434.9697651355164,111.0,12.579987,53.359038,-213,0.9194402420574886
16,0,76,61,61,Ronneburg,7580,19.13,5071,2517,2554,265,0.0,2.0,1174.5,110.9,12.184789,50.863458,-37,0.985512920908379
13,0,72,5261,95,Schwaan,18258,38.28,5070,2453,2617,132,0.0,2.0,1398.3447651355164,111.0,12.104643,53.976706,-164,0.9373328238440963
9,4,79,112,112,Arzberg,95659,43.19,5062,2518,2544,117,0.0,2.0,2480.028072733723,110.5,12.185347,50.057171,-26,0.9897798742138365
7,1,38,5007,73,Unkel,53572,8.16,5038,2401,2637,617,0.0,2.0,2725.5,109.8,7.251595,50.602142,-236,0.9105043610163064
9,4,72,5416,127,Creußen,95473,64.87,5027,2512,2515,77,0.0,2.0,2290.528072733723,110.5,11.624642,49.8444,-3,0.9988071570576541
9,3,75,5336,210,Wörth a.d.Donau,93086,52.24,5014,2549,2465,96,0.0,2.0,2397.153072733723,110.5,12.407619,49.000593,84,1.0340770791075051
16,0,63,82,82,Vacha,36404,44.41,5006,2490,2516,113,0.0,2.0,1289.0,110.9,10.023924,50.822993,-26,0.9896661367249603
9,3,76,151,151,Oberviechtach,92526,62.42,4994,2503,2491,80,0.0,2.0,2442.153072733723,110.5,12.418782,49.460918,12,1.004817342432758
5,7,62,24,24,Marienmünster,37696,64.36,4970,2504,2466,77,0.0,3.0,1469.5,110.4,9.229516,51.81928,38,1.0154095701540957
6,5,34,1,1,Amöneburg,35287,43.9,4963,2461,2502,113,0.0,2.0,1840.1597033712096,109.8,8.924741,50.796985,-41,0.9836131095123901
14,5,21,640,640,Thum,9419,18.9,4956,2427,2529,262,0.0,2.0,1039.5,110.3,12.951245,50.670506,-102,0.9596678529062871
9,3,74,168,168,Windischeschenbach,92670,36.37,4953,2470,2483,136,0.0,2.0,2510.028072733723,110.5,12.155614,49.803405,-13,0.9947643979057592
8,3,36,87,87,Todtnau,79674,69.75,4952,2462,2490,71,0.0,2.0,2324.0,109.5,7.947591,47.82939,-28,0.9887550200803212
7,1,40,5009,36,Emmelshausen,56281,8.05,4948,2405,2543,615,0.0,2.0,2655.5347033712096,109.8,7.588973,50.148471,-138,0.9457333857648447
9,4,72,5412,154,Hollfeld,96142,80.66,4947,2448,2499,61,0.0,2.0,1356.5,110.5,11.290753,49.937051,-51,0.9795918367346939
8,1,28,82,82,Niederstetten,97996,104.05,4941,2540,2401,47,0.0,2.0,2697.1446879301366,109.5,9.917243,49.401781,139,1.0578925447730112
7,3,32,5002,19,Freinsheim,67251,13.59,4939,2376,2563,363,0.0,2.0,2776.5,109.8,8.21286,49.507066,-187,0.927038626609442
8,3,17,5008,98,Oppenau,77728,72.98,4936,2455,2481,68,0.0,2.0,2293.0196879301366,109.5,8.165057,48.474717,-26,0.9895203546956872
1,0,54,138,138,Tönning,25832,44.43,4895,2405,2490,110,0.0,2.0,2519.0,109.4,8.941868,54.31662,-85,0.9658634538152611
12,0,72,5204,53,Dahme/Mark,15936,162.57,4868,2382,2486,30,0.0,2.0,1328.579749694436,110.7,13.428214,51.869415,-104,0.9581657280772325
6,6,33,25,25,Trendelburg,34388,69.37,4867,2420,2447,70,0.0,2.0,885.0,109.8,9.430291,51.575491,-27,0.9889660809154066
9,6,75,5616,139,Iphofen,97346,78.06,4859,2408,2451,62,0.0,2.0,2224.653072733723,110.5,10.259423,49.70383,-43,0.9824561403508771
9,5,75,5518,161,Scheinfeld,91443,45.12,4846,2461,2385,107,0.0,2.0,1861.5,110.5,10.462384,49.665093,76,1.0318658280922433
14,6,26,5232,450,Reichenbach/O.L.,2894,62.64,4844,2392,2452,77,0.0,2.0,1142.1013957730029,110.3,14.799946,51.141076,-60,0.9755301794453507
8,3,35,80,80,Tengen,78250,62.03,4840,2418,2422,78,0.0,2.0,2936.0,109.5,8.661028,47.821272,-4,0.9983484723369116
13,0,72,58,58,Kröpelin,18236,67.55,4829,2425,2404,71,0.0,2.0,1388.4697651355164,111.0,11.796062,54.071022,21,1.0087354409317804
8,1,35,5003,27,Niederstotzingen,89168,29.81,4828,2409,2419,162,0.0,2.0,2695.5196879301366,109.5,10.234998,48.541085,-10,0.9958660603555188
8,1,36,5004,38,Lauchheim,73466,40.86,4827,2445,2382,118,0.0,2.0,2760.5,109.5,10.245244,48.871764,63,1.026448362720403
14,6,25,630,630,Wilthen,2681,17.04,4827,2267,2560,283,0.0,2.0,1539.9763957730029,110.3,14.428566,51.092621,-293,0.885546875
16,0,63,5056,32,Geisa,36419,71.94,4823,2407,2416,67,0.0,2.0,2124.5,110.9,9.951776,50.755501,-9,0.9962748344370861
14,6,27,130,130,Lommatzsch,1623,66.63,4805,2343,2462,72,0.0,2.0,1050.7263957730029,110.3,13.30862,51.196631,-119,0.9516653127538587
9,6,73,117,117,Bischofsheim i.d.Rhön,97653,67.7,4799,2372,2427,71,0.0,2.0,2320.278072733723,110.5,10.008969,50.400975,-55,0.9773382777091059
6,4,32,9,9,Groß-Bieberau,64401,18.27,4782,2376,2406,262,0.0,2.0,2332.1597033712096,109.8,8.827307,49.801184,-30,0.9875311720698254
9,6,76,169,169,Wörth a.Main,63939,15.88,4779,2348,2431,301,0.0,2.0,2250.028072733723,110.5,9.156411,49.797293,-83,0.9658576717400247
13,0,76,5668,25,Crivitz,19089,75.85,4778,2261,2517,63,0.0,2.0,1455.5,111.0,11.695487,53.59356,-256,0.8982916170043703
9,4,78,176,176,Weismain,96260,90.14,4774,2425,2349,53,0.0,2.0,2416.028072733723,110.5,11.239386,50.084884,76,1.0323541932737335
15,0,90,5053,520,Seehausen (Altmark),39615,107.04,4773,2344,2429,45,0.0,2.0,1970.704749694436,110.7,11.982379,52.860907,-85,0.9650061753808151
8,3,26,5003,60,Triberg im Schwarzwald,78098,33.33,4767,2390,2377,143,0.0,2.0,1726.0,109.5,8.231158,48.128904,13,1.005469078670593
13,0,75,5552,31,Eggesin,17367,88.22,4748,2308,2440,54,0.0,2.0,1259.9697651355164,111.0,14.081578,53.68022,-132,0.9459016393442623
14,5,23,310,310,Pausa-Mühltroff,7952,64.13,4745,2342,2403,74,0.0,2.0,1230.2263957730029,110.3,11.997007,50.580559,-61,0.974615064502705
8,4,17,5006,57,Schömberg,72355,23.25,4741,2428,2313,204,0.0,2.0,2310.0,109.5,8.758829,48.211609,115,1.0497189796800692
14,5,23,10,10,Adorf/Vogtl.,8626,42.97,4729,2301,2428,110,0.0,2.0,1131.7263957730029,110.3,12.256069,50.320622,-127,0.9476935749588138
13,0,76,88,88,Lübtheen,19249,120.16,4715,2528,2187,39,0.0,2.0,1484.0,111.0,11.08294,53.30062,341,1.1559213534522177
13,0,74,5459,74,Schönberg,23923,52.19,4711,2327,2384,90,0.0,2.0,1404.3447651355164,111.0,10.811091,53.831497,-57,0.9760906040268457
12,0,67,5708,336,Müllrose,15299,69.23,4705,2244,2461,68,0.0,2.0,1929.5,110.7,14.394097,52.157661,-217,0.9118244616009752
13,0,73,55,55,Marlow,18337,140.52,4694,2412,2282,33,0.0,2.0,1297.9697651355164,111.0,12.570959,54.154202,130,1.0569675723049956
7,1,41,5010,91,Nassau,56377,17.55,4688,2331,2357,267,0.0,2.0,2380.7847033712096,109.8,7.767544,50.30832,-26,0.9889690284259652
6,5,35,8,8,Herbstein,36358,79.98,4685,2394,2291,59,0.0,2.0,1161.0,109.8,9.348731,50.562502,103,1.044958533391532
16,0,62,5053,64,Heringen/Helme,99765,66.91,4659,2375,2284,70,0.0,2.0,2109.2564266551562,110.9,10.939387,51.462524,91,1.0398423817863398
9,5,76,126,126,Heideck,91180,58.64,4659,2352,2307,79,0.0,2.0,2328.778072733723,110.5,11.126163,49.132203,45,1.0195058517555267
8,1,27,5005,89,Vellberg,74541,31.89,4654,2342,2312,146,0.0,2.0,2401.0,109.5,9.880771,49.086487,30,1.0129757785467128
14,6,25,5218,270,Königsbrück,1936,78.48,4651,2273,2378,59,0.0,2.0,1002.3513957730029,110.3,13.956211,51.330628,-105,0.9558452481076535
8,1,26,5002,45,Krautheim,74238,52.9,4650,2459,2191,88,0.0,2.0,1865.5,109.5,9.634435,49.384904,268,1.1223185759926975
8,4,26,5001,13,Bad Buchau,88422,23.75,4636,2359,2277,195,0.0,2.0,2519.6446879301366,109.5,9.621543,48.102679,82,1.0360122968818621
16,0,63,5006,104,Amt Creuzburg,99831,69.73,4628,2357,2271,66,0.0,2.0,1149.0,110.9,10.242324,51.051684,86,1.0378687802730076
15,0,84,5053,135,Freyburg (Unstrut),6632,46.56,4596,2239,2357,99,0.0,2.0,1470.204749694436,110.7,11.732025,51.204907,-118,0.9499363597793806
8,1,28,20,20,Creglingen,97993,117.23,4595,2360,2235,39,0.0,2.0,1901.5,109.5,10.032709,49.470427,125,1.0559284116331096
6,6,31,23,23,Tann (Rhön),36142,60.45,4565,2342,2223,76,0.0,2.0,1745.1597033712096,109.8,10.023386,50.643742,119,1.0535312640575798
7,3,32,5006,46,Wachenheim an der Weinstraße,67157,24.97,4561,2207,2354,183,0.0,2.0,2253.0347033712096,109.8,8.180798,49.439981,-147,0.937553101104503
7,1,34,5001,5,Baumholder,55774,69.19,4560,2177,2383,66,0.0,2.0,1169.0,109.8,7.336809,49.615797,-206,0.9135543432647922
8,1,27,5004,32,Gerabronn,74582,40.38,4546,2271,2275,113,0.0,2.0,2440.3946879301366,109.5,9.922672,49.251834,-4,0.9982417582417582
14,5,21,160,160,Ehrenfriedersdorf,9427,15.89,4541,2191,2350,286,0.0,2.0,1288.0,110.3,12.969994,50.646799,-159,0.9323404255319149
5,9,58,20,20,Hallenberg,59969,65.35,4537,2335,2202,69,0.0,3.0,1781.8071583030323,110.4,8.621165,51.111987,133,1.0603996366939146
7,3,40,5001,4,Dahn,66994,40.76,4532,2228,2304,111,0.0,2.0,1872.5,109.8,7.778207,49.151331,-76,0.9670138888888888
13,0,73,70,70,Putbus,18581,66.69,4531,2202,2329,68,0.0,2.0,1410.5947651355164,111.0,13.47642,54.35431,-127,0.9454701588664663
9,4,72,116,116,Bad Berneck i.Fichtelgebirge,95460,38.26,4510,2266,2244,118,0.0,2.0,2437.403072733723,110.5,11.667129,50.043667,22,1.0098039215686274
14,5,22,20,20,Augustusburg,9573,23.38,4495,2198,2297,192,0.0,2.0,1198.5,110.3,13.10168,50.810614,-99,0.95690030474532
6,5,34,17,17,Rauschenberg,35282,67.32,4488,2224,2264,67,0.0,2.0,1790.4097033712096,109.8,8.914798,50.883471,-40,0.9823321554770318
14,5,24,90,90,Hartenstein,8118,36.7,4486,2193,2293,122,0.0,2.0,1189.2263957730029,110.3,12.671366,50.661865,-100,0.9563890100305277
12,0,65,193,193,Liebenwalde,16559,142.14,4481,2252,2229,32,0.0,2.0,2113.5,110.7,13.393076,52.871681,23,1.0103185284881113
8,1,27,5008,46,Kirchberg an der Jagst,74592,40.93,4456,2400,2056,109,0.0,2.0,2427.5196879301366,109.5,9.981388,49.20226,344,1.1673151750972763
13,0,75,130,130,Strasburg (Uckermark),17335,87.48,4451,2173,2278,51,0.0,2.0,1409.2197651355164,111.0,13.744259,53.506373,-105,0.9539069359086918
8,2,26,5007,80,Schönau,69250,22.49,4449,2223,2226,198,0.0,2.0,2345.5,109.5,8.808894,49.435936,-3,0.9986522911051213
7,1,43,5006,286,Rennerod,56477,18.14,4448,2242,2206,245,0.0,2.0,2478.4097033712096,109.8,8.076546,50.657462,36,1.016319129646419
14,6,28,300,300,Rabenau,1734,30.73,4448,2228,2220,145,0.0,2.0,1650.0,110.3,13.642121,50.965305,8,1.0036036036036036
12,0,71,5107,304,Peitz/Picnjo,3185,13.49,4427,2121,2306,328,0.0,2.0,1704.954749694436,110.7,14.323575,51.890673,-185,0.9197745013009541
9,4,75,169,169,Schwarzenbach a.Wald,95131,36.7,4417,2145,2272,120,0.0,2.0,2491.528072733723,110.5,11.624044,50.284917,-127,0.9441021126760564
7,1,41,5007,92,Nastätten,56355,13.05,4409,2140,2269,338,0.0,2.0,2128.0,109.8,7.869656,50.233054,-129,0.9431467606875276
9,3,74,5327,117,Eschenbach i.d.OPf.,92676,35.13,4399,2134,2265,125,0.0,2.0,2385.653072733723,110.5,11.834496,49.753093,-131,0.9421633554083885
14,6,26,5235,480,Rothenburg/O.L.,2929,72.41,4389,2213,2176,61,0.0,2.0,1132.7263957730029,110.3,14.966788,51.33588,37,1.0170036764705883
1,0,54,5488,164,Wyk auf Föhr,25938,8.08,4380,2046,2334,542,0.0,2.0,2757.306349449769,109.4,8.511244,54.708245,-288,0.8766066838046273
3,1,59,5401,9,Dransfeld,37127,28.91,4378,2132,2246,151,0.0,2.0,2010.5,110.0,9.677991,51.484852,-114,0.9492430988423864
13,0,71,27,27,Dargun,17159,118.01,4371,2140,2231,37,0.0,2.0,1290.2197651355164,111.0,12.853692,53.898212,-91,0.9592111160914388
1,0,61,113,113,Wilster,25554,2.71,4369,2152,2217,1612,0.0,2.0,3782.931349449769,109.4,9.374577,53.922543,-65,0.970681100586378
5,3,58,12,12,Heimbach,52396,64.96,4365,2177,2188,67,0.0,3.0,1983.0,110.4,6.480769,50.633398,-11,0.9949725776965265
12,0,72,14,14,Baruth/Mark,15837,233.83,4318,2232,2086,18,0.0,2.0,2163.5,110.7,13.504113,52.049327,146,1.0699904122722914
16,0,67,65,65,Tambach-Dietharz/Thür. Wald,99897,41.64,4318,2174,2144,104,0.0,2.0,2287.8814266551562,110.9,10.608225,50.792126,30,1.0139925373134329
9,4,74,5427,132,Gräfenberg,91322,37.83,4294,2174,2120,114,0.0,2.0,2313.528072733723,110.5,11.248666,49.646221,54,1.0254716981132075
9,3,74,5324,149,Pressath,92690,66.34,4289,2130,2159,65,0.0,2.0,1606.5,110.5,11.935175,49.769201,-29,0.9865678554886521
8,3,17,51,51,Hornberg,78132,54.45,4271,2142,2129,78,0.0,2.0,2384.7696879301366,109.5,8.229573,48.212461,13,1.0061061531235322
9,4,72,139,139,Gefrees,95482,50.32,4264,2037,2227,85,0.0,2.0,1573.0,110.5,11.73828,50.094949,-190,0.914683430624158
13,0,75,5558,82,Loitz,17121,89.91,4262,2111,2151,47,0.0,2.0,1273.2197651355164,111.0,13.271276,53.991357,-40,0.9814039981403998
9,3,71,150,150,Schnaittenbach,92253,63.41,4260,2156,2104,67,0.0,2.0,2392.903072733723,110.5,12.003698,49.547992,52,1.0247148288973384
7,1,40,5008,125,Rheinböllen,55494,16.36,4249,2112,2137,260,0.0,2.0,1940.5,109.8,7.605169,50.021632,-25,0.988301357042583
9,4,75,171,171,Selbitz,95152,27.75,4249,2031,2218,153,0.0,2.0,2531.403072733723,110.5,11.7481,50.31501,-187,0.9156898106402164
6,6,36,12,12,Waldkappel,37284,96.53,4231,2115,2116,44,0.0,2.0,1733.5347033712096,109.8,9.874129,51.143533,-1,0.9995274102079396
8,2,26,5009,55,Neckarbischofsheim,74924,26.41,4230,2152,2078,160,0.0,2.0,2236.5,109.5,8.960914,49.294478,74,1.0356111645813282
6,6,36,13,13,Wanfried,37281,46.88,4227,2074,2153,90,0.0,2.0,1817.5347033712096,109.8,10.170055,51.183286,-79,0.9633070134695774
7,1,32,5003,18,Daaden,57567,19.58,4225,2069,2156,216,0.0,2.0,1339.5,109.8,7.967583,50.739178,-87,0.9596474953617811
9,3,77,157,157,Waldershof,95679,60.37,4212,2063,2149,70,0.0,2.0,2483.778072733723,110.5,12.063474,49.977751,-86,0.9599813866914844
12,0,69,5904,76,Brück,14822,86.19,4209,2121,2088,49,0.0,2.0,2370.5,110.7,12.857467,52.225651,33,1.0158045977011494
13,0,71,5164,164,Woldegk,17348,164.17,4196,2073,2123,26,0.0,2.0,1223.9697651355164,111.0,13.58319,53.459087,-50,0.976448422044277
14,7,30,60,60,Dahlen,4774,71.87,4171,2033,2138,58,0.0,2.0,1011.5,110.3,12.996492,51.366843,-105,0.95088868101029
7,3,32,5005,32,Lambrecht (Pfalz),67466,8.32,4170,2030,2140,501,0.0,2.0,2533.9097033712096,109.8,8.070859,49.372252,-110,0.9485981308411215
8,3,37,5006,97,St. Blasien,79837,54.41,4169,2038,2131,77,0.0,2.0,2162.0,109.5,8.16842,47.754099,-93,0.9563585171281088
14,5,22,190,190,Geringswalde,9326,30.05,4158,2025,2133,138,0.0,2.0,1260.9763957730029,110.3,12.903355,51.076992,-108,0.9493670886075949
8,1,26,5004,60,Niedernhall,74676,17.71,4142,2093,2049,234,0.0,2.0,2398.5,109.5,9.617131,49.294782,44,1.0214738897022937
7,1,35,5005,92,Zell (Mosel),56856,44.95,4107,2039,2068,91,0.0,2.0,2174.6597033712096,109.8,7.181996,50.027298,-29,0.9859767891682786
7,1,40,5004,67,Kirchberg (Hunsrück),55481,18.05,4107,2038,2069,228,0.0,2.0,2318.6597033712096,109.8,7.383443,49.92535,-31,0.9850169163847269
13,0,71,5158,115,Penzlin,17217,115.56,4094,2032,2062,35,0.0,2.0,1402.5,111.0,13.087659,53.505303,-30,0.98545101842871
14,5,22,350,350,Lunzenau,9328,28.33,4080,2004,2076,144,0.0,2.0,1349.2263957730029,110.3,12.754155,50.95988,-72,0.9653179190751445
6,5,31,1,1,Allendorf (Lumda),35469,22.05,4065,2068,1997,184,0.0,2.0,1896.5347033712096,109.8,8.822783,50.677705,71,1.0355533299949924
13,0,74,5459,17,Dassow,23942,66.96,4038,2026,2012,60,0.0,2.0,2523.5,111.0,11.045858,53.970527,14,1.0069582504970178
15,0,89,5052,165,Güsten,39439,36.17,4038,1971,2067,112,0.0,2.0,1886.079749694436,110.7,11.605461,51.794501,-96,0.95355587808418
13,0,72,74,74,Neubukow,18233,25.14,4037,1982,2055,161,0.0,2.0,1513.4697651355164,111.0,11.673184,54.032344,-73,0.9644768856447689
13,0,76,5664,128,Sternberg,19406,67.69,4023,1961,2062,59,0.0,2.0,1296.5,111.0,11.951301,53.663979,-101,0.9510184287099903
6,4,31,18,18,Neckarsteinach,69239,17.24,4016,2012,2004,233,0.0,2.0,2356.4097033712096,109.8,8.839114,49.40797,8,1.003992015968064
9,4,71,5401,115,Baunach,96148,32.14,4015,2006,2009,125,0.0,2.0,2623.0,110.5,10.850053,49.988184,-3,0.9985067197610752
13,0,74,5457,57,Neukloster,23992,27.51,4014,2024,1990,146,0.0,2.0,1459.9697651355164,111.0,11.737231,53.911906,34,1.0170854271356784
13,0,72,5262,105,Tessin,18195,24.51,4012,1968,2044,164,0.0,2.0,1800.0,111.0,12.357532,53.98997,-76,0.9628180039138943
9,5,77,5534,125,Ellingen,91792,31.25,3991,1961,2030,128,0.0,2.0,2312.528072733723,110.5,10.967915,49.060787,-69,0.9660098522167487
9,6,75,5618,147,Marktbreit,97340,20.16,3986,2065,1921,198,0.0,2.0,2285.5,110.5,10.144126,49.668679,144,1.0749609578344612
3,2,56,5409,14,Hoya,27318,8.45,3972,1912,2060,470,0.0,2.0,2215.08638033193,110.0,9.149399,52.844913,-148,0.9281553398058252
9,5,77,158,158,Pappenheim,91788,64.32,3969,1999,1970,62,0.0,2.0,1944.0,110.5,10.974589,48.934776,29,1.0147208121827411
6,6,35,12,12,Gemünden (Wohra),35285,58.65,3961,1971,1990,68,0.0,1.0,1712.2922793215403,109.8,8.969926,50.971221,-19,0.9904522613065326
14,5,24,5135,290,Waldenburg,8396,25.06,3938,1949,1989,157,0.0,2.0,2572.0,110.3,12.536763,50.892077,-40,0.9798893916540975
9,6,76,112,112,Amorbach,63916,50.9,3933,1913,2020,77,0.0,2.0,2001.153072733723,110.5,9.21813,49.644565,-107,0.947029702970297
9,4,73,165,165,Seßlach,96145,72.53,3908,1985,1923,54,0.0,2.0,1822.5,110.5,10.84159,50.188751,62,1.032241289651586
13,0,71,5155,99,Mirow,17252,158.28,3887,1880,2007,25,0.0,2.0,1195.7197651355164,111.0,12.815475,53.274554,-127,0.9367214748380668
14,5,21,670,670,Wolkenstein,9429,30.51,3837,1901,1936,126,0.0,2.0,1492.3513957730029,110.3,13.067596,50.65634,-35,0.9819214876033058
7,2,32,5007,123,Speicher,54662,15.36,3836,1928,1908,250,0.0,2.0,1726.5,109.8,6.662445,49.953427,20,1.0104821802935011
14,7,29,360,360,Regis-Breitingen,4565,26.37,3796,1868,1928,144,0.0,2.0,1263.9763957730029,110.3,12.434362,51.087869,-60,0.9688796680497925
14,5,21,320,320,Johanngeorgenstadt,8349,29.59,3783,1829,1954,128,0.0,2.0,1304.9763957730029,110.3,12.721689,50.429487,-125,0.936028659160696
7,3,32,5001,9,Deidesheim,67146,26.54,3772,1814,1958,142,0.0,2.0,3990.5,109.8,8.186692,49.409358,-144,0.9264555669050051
12,0,66,5607,272,Ruhland,1945,37.22,3770,1837,1933,101,0.0,2.0,1414.642249694436,110.7,13.769359,51.416001,-96,0.950336264873254
8,3,25,5004,51,Schiltach,77761,34.21,3764,1863,1901,110,0.0,2.0,2071.0,109.5,8.342344,48.290209,-38,0.9800105207785376
14,7,29,400,400,Trebsen/Mulde,4687,35.05,3762,1866,1896,107,0.0,2.0,1245.9763957730029,110.3,12.754884,51.289139,-30,0.9841772151898734
14,6,26,5203,10,Bad Muskau / Mužakow,2953,15.38,3759,1847,1912,244,0.0,2.0,1087.9138957730029,110.3,14.721746,51.545194,-65,0.9660041841004184
8,1,28,5003,47,Grünsfeld,97947,44.72,3759,1893,1866,84,0.0,2.0,2009.5,109.5,9.744701,49.607521,27,1.0144694533762058
14,5,23,5120,260,Netzschkau,8491,12.51,3756,1817,1939,300,0.0,2.0,1360.6638957730029,110.3,12.251439,50.582281,-122,0.9370809695719443
16,0,68,5005,64,Kindelbrück,99638,57.84,3747,1890,1857,65,0.0,2.0,1136.0,110.9,11.154924,51.247609,33,1.0177705977382876
14,5,23,100,100,Elsterberg,7985,25.1,3738,1797,1941,149,0.0,2.0,1221.6638957730029,110.3,12.169477,50.608182,-144,0.9258114374034003
8,3,26,68,68,Vöhrenbach,78147,70.47,3698,1880,1818,52,0.0,2.0,2220.0,109.5,8.304492,48.045545,62,1.034103410341034
6,6,33,2,2,Bad Karlshafen,34385,14.85,3695,1836,1859,249,0.0,2.0,1921.7222033712096,109.8,9.453624,51.643844,-23,0.9876277568585261
9,1,82,132,132,Tegernsee,83684,22.74,3693,1752,1941,162,0.0,2.0,10488.0,110.5,11.757111,47.70869,-189,0.9026275115919629
14,6,27,270,270,Strehla,1616,30.28,3680,1775,1905,122,0.0,2.0,1197.6013957730029,110.3,13.225692,51.352691,-130,0.931758530183727
3,2,55,5409,13,Eschershausen,37632,23.92,3644,1804,1840,152,0.0,2.0,919.0,110.0,9.778045,51.875883,-36,0.9804347826086957
14,5,23,40,40,Bad Elster,8645,19.77,3644,1729,1915,184,0.0,2.0,1233.7888957730029,110.3,12.238262,50.282643,-186,0.9028720626631854
16,0,72,19,19,Steinach,96523,26.35,3641,1796,1845,138,0.0,2.0,2306.5689266551562,110.9,11.158066,50.432443,-49,0.9734417344173442
16,0,68,58,58,Weißensee,99631,55.33,3633,1782,1851,66,0.0,2.0,1362.5,110.9,11.067924,51.195862,-69,0.9627228525121556
16,0,75,5011,116,Triptis,7819,33.15,3632,1809,1823,110,0.0,2.0,1314.6939266551562,110.9,11.797266,50.739567,-14,0.9923203510696654
14,6,26,530,530,Seifhennersdorf,2782,19.12,3628,1775,1853,190,0.0,2.0,771.5,110.3,14.618954,50.933623,-78,0.9579060982191041
8,3,27,5001,36,Mühlheim an der Donau,78570,21.74,3627,1771,1856,167,0.0,2.0,2464.0196879301366,109.5,8.888573,48.023075,-85,0.9542025862068966
9,6,74,164,164,Königsberg i.Bay.,97486,61.88,3624,1806,1818,59,0.0,2.0,2342.778072733723,110.5,10.569258,50.080997,-12,0.9933993399339934
13,0,74,5458,65,Rehna,19217,44.59,3605,1790,1815,81,0.0,2.0,2463.0,111.0,10.935979,53.758146,-25,0.9862258953168044
15,0,83,5054,245,Gröningen,39397,59.73,3573,1762,1811,60,0.0,2.0,1040.0,110.7,11.219229,51.936468,-49,0.9729431253451132
1,0,51,5178,127,Wesselburen,25764,5.13,3564,1712,1852,695,0.0,2.0,2848.931349449769,109.4,8.941082,54.157516,-140,0.9244060475161987
14,5,24,310,310,Wildenfels,8134,20.68,3556,1789,1767,172,0.0,2.0,1355.1013957730029,110.3,12.584707,50.6286,22,1.0124504810413129
16,0,77,28,28,Lucka,4613,12.93,3530,1693,1837,273,0.0,2.0,969.5,110.9,12.331368,51.097963,-144,0.9216113228089275
12,0,62,5031,341,Mühlberg/Elbe,4931,89.2,3514,1734,1780,39,0.0,2.0,1370.767249694436,110.7,13.220314,51.434662,-46,0.9741573033707865
9,4,72,143,143,Goldkronach,95497,30.68,3513,1724,1789,115,0.0,2.0,1900.0,110.5,11.686917,50.010871,-65,0.9636668529904975
12,0,68,5805,324,Neustadt (Dosse),16845,75.87,3499,1697,1802,46,0.0,2.0,1532.579749694436,110.7,12.369177,52.791655,-105,0.94173140954495
9,5,75,5524,115,Burgbernheim,91593,42.3,3483,1730,1753,82,0.0,2.0,2241.840572733723,110.5,10.324447,49.450379,-23,0.9868796349115802
8,1,16,5002,54,Owen,73277,9.7,3478,1745,1733,359,0.0,2.0,3807.0,109.5,9.451611,48.58688,12,1.006924408540104
7,1,33,5011,103,Stromberg,55442,9.01,3477,1642,1835,386,0.0,2.0,2443.4097033712096,109.8,7.752092,49.965906,-193,0.8948228882833787
7,1,35,5003,83,Ulmen,56766,28.74,3475,1725,1750,121,0.0,2.0,1514.5,109.8,7.002278,50.186485,-25,0.9857142857142858
6,4,31,12,12,Hirschhorn (Neckar),69434,30.85,3449,1697,1752,112,0.0,2.0,2243.8472033712096,109.8,8.896627,49.447519,-55,0.968607305936073
12,0,60,5006,100,Joachimsthal,16247,121.68,3446,1699,1747,28,0.0,2.0,2015.5,110.7,13.806665,52.962341,-48,0.9725243274184316
7,1,37,5002,501,Münstermaifeld,56294,27.77,3443,1646,1797,124,0.0,2.0,2451.7222033712096,109.8,7.344588,50.272568,-151,0.9159710628825821
13,0,72,5256,56,Krakow am See,18292,87.36,3442,1706,1736,39,0.0,2.0,1253.0322651355164,111.0,12.333192,53.616837,-30,0.9827188940092166
16,0,77,5050,12,Gößnitz,4639,14.07,3433,1677,1756,244,0.0,2.0,1020.5,110.9,12.433836,50.888453,-79,0.9550113895216401
14,6,28,5204,30,Bad Schandau,1814,46.78,3421,1675,1746,73,0.0,2.0,927.9763957730029,110.3,14.154659,50.917397,-71,0.9593356242840779
16,0,75,132,132,Tanna,7922,87.35,3421,1706,1715,39,0.0,2.0,1308.9439266551562,110.9,11.856569,50.493599,-9,0.9947521865889213
8,1,25,5011,59,Löwenstein,74245,23.46,3419,1705,1714,146,0.0,2.0,3126.0,109.5,9.380173,49.095993,-9,0.9947491248541424
16,0,73,5012,113,Schwarzatal,98744,25.98,3393,1646,1747,131,0.0,2.0,2293.1314266551562,110.9,11.127782,50.571828,-101,0.9421866056096165
8,1,18,5008,59,Oberriexingen,71739,8.16,3379,1689,1690,414,0.0,2.0,3686.0,109.5,9.029526,48.927122,-1,0.9994082840236687
14,5,21,5110,210,Geyer,9468,18.56,3366,1616,1750,181,0.0,2.0,1224.7888957730029,110.3,12.924195,50.623705,-134,0.9234285714285714
16,0,76,5051,3,Bad Köstritz,7586,16.93,3365,1608,1757,199,0.0,2.0,1353.1314266551562,110.9,11.914412,50.875946,-149,0.9151963574274331
13,0,76,5656,48,Goldberg,19399,64.72,3364,1625,1739,52,0.0,2.0,1178.0,111.0,12.070443,53.622107,-114,0.9344450833812536
16,0,69,5004,63,Heldburg,98663,112.74,3362,1722,1640,30,0.0,2.0,2073.6939266551562,110.9,10.622424,50.328646,82,1.05
9,3,72,154,154,Rötz,92444,66.67,3358,1721,1637,50,0.0,2.0,1383.5,110.5,12.531008,49.342287,84,1.051313378130727
16,0,76,92,92,Auma-Weidatal,7955,55.91,3353,1678,1675,60,0.0,2.0,1337.6939266551562,110.9,11.900885,50.699794,3,1.0017910447761194
9,6,73,5639,153,Ostheim v.d.Rhön,97645,40.85,3323,1623,1700,81,0.0,2.0,2271.090572733723,110.5,10.230125,50.457945,-77,0.9547058823529412
9,4,76,152,152,Ludwigsstadt,96337,58.74,3322,1619,1703,57,0.0,2.0,1061.0,110.5,11.389636,50.484915,-84,0.9506752789195537
16,0,75,135,135,Saalburg-Ebersdorf,7929,72.05,3319,1643,1676,46,0.0,2.0,1330.0689266551562,110.9,11.667186,50.484382,-33,0.9803102625298329
16,0,71,5007,46,Kranichfeld,99448,23.1,3313,1647,1666,143,0.0,2.0,1601.5,110.9,11.160457,50.878926,-19,0.9885954381752701
12,0,71,408,408,Welzow/Wjelcej,3119,39.57,3297,1620,1677,83,0.0,2.0,1609.704749694436,110.7,14.171628,51.581019,-57,0.9660107334525939
16,0,72,15,15,Schalkau,96528,44.02,3266,1643,1623,74,0.0,2.0,2232.1939266551562,110.9,11.005007,50.393575,20,1.0123228589032656
7,1,35,5002,45,Kaisersesch,56759,8.18,3254,1567,1687,398,0.0,2.0,1763.5,109.8,7.073634,50.248217,-120,0.9288678126852401
8,2,35,5005,84,Bad Teinach-Zavelstein,75385,25.17,3251,1684,1567,129,0.0,2.0,2507.0196879301366,109.5,8.688173,48.688772,117,1.0746649649010849
7,2,33,5006,29,Hillesheim,54576,20.66,3240,1604,1636,157,0.0,2.0,1940.5,109.8,6.662659,50.261063,-32,0.980440097799511
14,6,26,5206,30,Bernstadt a. d. Eigen,2748,52.0,3229,1621,1608,62,0.0,2.0,907.2263957730029,110.3,14.826935,51.047102,13,1.0080845771144278
12,0,69,5902,270,Havelsee,14798,81.97,3229,1614,1615,39,0.0,2.0,1700.5,110.7,12.455492,52.495639,-1,0.9993808049535604
15,0,87,5051,250,Kelbra (Kyffhäuser),6537,40.56,3220,1597,1623,79,0.0,2.0,1535.204749694436,110.7,11.041425,51.435698,-26,0.9839802834257547
16,0,76,4,4,Berga/Elster,7980,43.52,3218,1610,1608,74,0.0,2.0,1314.1939266551562,110.9,12.16193,50.752198,2,1.0012437810945274
15,0,89,5051,75,Egeln,39435,29.23,3216,1592,1624,110,0.0,2.0,1066.0,110.7,11.512902,51.931964,-32,0.9802955665024631
9,4,77,5435,156,Stadtsteinach,95346,39.8,3205,1588,1617,81,0.0,2.0,2363.653072733723,110.5,11.503963,50.163192,-29,0.9820655534941249
14,6,28,190,190,Hohnstein,1848,64.64,3201,1614,1587,50,0.0,2.0,1181.5,110.3,14.110821,50.979682,27,1.0170132325141776
6,5,35,10,10,Kirtorf,36320,79.91,3199,1585,1614,40,0.0,2.0,1771.4722033712096,109.8,9.105878,50.768346,-29,0.9820322180916976
13,0,74,5457,84,Warin,19417,44.45,3195,1600,1595,72,0.0,2.0,1826.0,111.0,11.578071,53.785613,5,1.0031347962382444
16,0,72,11,11,Lauscha,98724,18.72,3188,1559,1629,170,0.0,2.0,2360.8189266551562,110.9,11.159835,50.476118,-70,0.9570288520564764
9,4,79,150,150,Schönwald,95173,19.19,3183,1517,1666,166,0.0,2.0,2563.903072733723,110.5,12.088155,50.198824,-149,0.9105642256902761
9,6,75,158,158,Prichsenstadt,97357,48.87,3179,1632,1547,65,0.0,2.0,1771.5,110.5,10.350427,49.817844,85,1.054945054945055
9,5,71,5538,229,Wolframs-Eschenbach,91639,25.47,3178,1533,1645,125,0.0,2.0,2332.778072733723,110.5,10.723299,49.226119,-112,0.9319148936170213
12,0,62,469,469,Sonnewalde,3249,119.29,3169,1609,1560,27,0.0,2.0,1284.0,110.7,13.644831,51.695472,49,1.0314102564102565
14,6,26,5224,350,Neusalza-Spremberg,2742,22.91,3165,1580,1585,138,0.0,2.0,1169.6638957730029,110.3,14.531654,51.037369,-5,0.9968454258675079
12,0,64,5406,268,Lebus,15326,54.42,3161,1569,1592,58,0.0,2.0,1538.0,110.7,14.539936,52.425777,-23,0.9855527638190955
9,4,79,129,129,Kirchenlamitz,95158,48.48,3153,1545,1608,65,0.0,2.0,2438.153072733723,110.5,11.950309,50.151691,-63,0.960820895522388
13,0,74,5454,39,Klütz,23948,44.43,3153,1473,1680,71,0.0,2.0,1384.0947651355164,111.0,11.153059,53.928323,-207,0.8767857142857143
12,0,73,384,384,Lychen,17279,111.98,3140,1509,1631,28,0.0,2.0,2155.0,110.7,13.315316,53.210926,-122,0.9251992642550583
12,0,71,5102,44,Döbern/Derbno,3159,15.79,3126,1498,1628,198,0.0,2.0,1448.892249694436,110.7,14.597678,51.614654,-130,0.9201474201474201
9,6,79,5646,124,Eibelstadt,97246,7.07,3120,1504,1616,441,0.0,2.0,3065.0,110.5,10.000876,49.724853,-112,0.9306930693069307
8,3,27,5001,16,Fridingen an der Donau,78567,22.47,3116,1567,1549,139,0.0,2.0,2424.0196879301366,109.5,8.932884,48.021685,18,1.0116204002582312
9,4,72,197,197,Waischenfeld,91344,57.93,3105,1621,1484,54,0.0,2.0,1929.0,110.5,11.344906,49.845149,137,1.0923180592991915
15,0,84,5053,360,Nebra (Unstrut),6642,25.43,3085,1532,1553,121,0.0,2.0,1624.454749694436,110.7,11.460967,51.247883,-21,0.9864777849323889
9,4,79,166,166,Weißenstadt,95163,42.23,3072,1536,1536,73,0.0,2.0,1215.0,110.5,11.885088,50.101234,0,1.0
9,5,71,177,177,Merkendorf,91732,26.07,3071,1563,1508,118,0.0,2.0,2294.5,110.5,10.701601,49.203432,55,1.0364721485411141
14,6,25,610,610,Weißenberg / Wóspork,2627,50.96,3062,1540,1522,60,0.0,2.0,1296.4138957730029,110.3,14.57016,51.148497,18,1.011826544021025
9,3,77,112,112,Bärnau,95671,74.41,3061,1566,1495,41,0.0,2.0,2417.215572733723,110.5,12.429932,49.809434,71,1.0474916387959867
13,0,71,5155,159,Wesenberg,17255,89.65,3057,1505,1552,34,0.0,2.0,1867.0,111.0,13.036122,53.219063,-47,0.9697164948453608
12,0,68,5804,280,Lindow (Mark),16835,65.47,3048,1549,1499,47,0.0,2.0,1510.767249694436,110.7,12.96994,52.902818,50,1.0333555703802535
7,1,37,5009,221,Rhens,56321,16.31,3037,1478,1559,186,0.0,2.0,2196.5,109.8,7.626757,50.272043,-81,0.9480436177036562
16,0,74,5051,9,Bürgel,7616,27.19,3033,1500,1533,112,0.0,2.0,1255.3189266551562,110.9,11.759303,50.942415,-33,0.9784735812133072
6,5,35,18,18,Ulrichstein,35327,65.61,3028,1520,1508,46,0.0,2.0,1474.5,109.8,9.192283,50.576648,12,1.0079575596816976
12,0,62,461,461,Schönewalde,4916,156.16,3004,1531,1473,19,0.0,2.0,1248.0,110.7,13.23544,51.69229,58,1.0393754243041413
14,5,23,5131,370,Schöneck/Vogtl.,8261,55.03,2997,1445,1552,54,0.0,2.0,1171.6638957730029,110.3,12.33053,50.39283,-107,0.9310567010309279
16,0,75,133,133,Wurzbach,7343,72.32,2996,1504,1492,41,0.0,1.0,1270.576502605487,110.9,11.536895,50.463722,12,1.0080428954423593
6,6,33,16,16,Liebenau,34396,48.88,2989,1477,1512,61,0.0,2.0,948.0,109.8,9.283728,51.494423,-35,0.9768518518518519
13,0,76,5654,34,Dömitz,19303,60.57,2981,1484,1497,49,0.0,2.0,1300.4697651355164,111.0,11.248957,53.141778,-13,0.991315965263861
7,1,41,5009,501,Braubach,56338,19.5,2975,1494,1481,153,0.0,2.0,1921.0,109.8,7.648315,50.274481,13,1.0087778528021607
13,0,75,5563,44,Gützkow,17506,57.65,2974,1509,1465,52,0.0,2.0,1284.0322651355164,111.0,13.378573,53.964782,44,1.0300341296928328
6,6,35,14,14,Hatzfeld (Eder),35116,58.51,2963,1475,1488,51,0.0,2.0,1743.5347033712096,109.8,8.547851,50.993022,-13,0.991263440860215
8,2,25,5007,114,Ravenstein,74747,55.97,2961,1539,1422,53,0.0,2.0,1705.0,109.5,9.508202,49.401829,117,1.0822784810126582
7,1,31,5001,1,Adenau,53518,18.56,2956,1471,1485,159,0.0,2.0,2143.9097033712096,109.8,6.930224,50.382256,-14,0.9905723905723905
16,0,76,5006,49,Münchenbernsdorf,7589,15.45,2939,1421,1518,190,0.0,2.0,842.0,110.9,11.966612,50.820323,-97,0.9361001317523057
7,1,43,5007,67,Selters (Westerwald),56242,8.7,2937,1430,1507,338,0.0,2.0,2451.5347033712096,109.8,7.724221,50.515578,-77,0.948905109489051
6,6,35,10,10,Frankenau,35110,57.29,2933,1450,1483,51,0.0,3.0,1410.5,109.8,8.934861,51.090496,-33,0.9777478084962913
7,1,40,5009,133,Sankt Goar,56329,23.17,2928,1459,1469,126,0.0,2.0,2271.4722033712096,109.8,7.713464,50.150992,-10,0.9931926480599047
13,0,75,5554,54,Jarmen,17126,30.71,2914,1429,1485,95,0.0,2.0,1349.1572651355164,111.0,13.340233,53.924079,-56,0.9622895622895623
9,4,79,135,135,Marktleuthen,95168,35.48,2899,1406,1493,82,0.0,2.0,1113.5,110.5,11.994074,50.127998,-87,0.941728064300067
7,1,40,5009,112,Oberwesel,55430,18.08,2864,1412,1452,158,0.0,2.0,2283.5972033712096,109.8,7.722947,50.106015,-40,0.9724517906336089
7,1,33,5010,65,Meisenheim,55590,10.33,2839,1367,1472,275,0.0,2.0,2324.1597033712096,109.8,7.670811,49.705645,-105,0.9286684782608695
13,0,72,5254,35,Gnoien,17179,41.11,2838,1373,1465,69,0.0,2.0,1520.5,111.0,12.738972,53.898718,-92,0.9372013651877134
9,5,71,5502,198,Schillingsfürst,91583,27.5,2825,1449,1376,103,0.0,2.0,2286.840572733723,110.5,10.187948,49.309419,73,1.0530523255813953
1,0,54,5417,36,Garding,25836,3.06,2823,1380,1443,923,0.0,2.0,3010.181349449769,109.4,8.78356,54.317383,-63,0.9563409563409564
15,0,84,5053,285,Laucha an der Unstrut,6636,31.17,2798,1434,1364,90,0.0,2.0,892.0,110.7,11.676223,51.223667,70,1.0513196480938416
8,3,15,5012,111,Sulzburg,79295,22.74,2781,1351,1430,122,0.0,2.0,2394.8321879301366,109.5,7.710087,47.839883,-79,0.9447552447552447
3,3,54,5407,26,Wustrow (Wendland),29462,30.19,2779,1388,1391,92,0.0,2.0,1839.5238803319298,110.0,11.119401,52.924056,-3,0.9978432782171099
14,5,21,5140,180,Elterlein,9481,45.74,2766,1364,1402,60,0.0,2.0,741.5,110.3,12.912503,50.54137,-38,0.9728958630527818
16,0,69,5002,51,Themar,98660,20.18,2744,1357,1387,136,0.0,2.0,2238.8189266551562,110.9,10.596773,50.472586,-30,0.9783705839942322
14,5,22,170,170,Frauenstein,9623,58.98,2714,1366,1348,46,0.0,2.0,1146.3513957730029,110.3,13.533996,50.801948,18,1.013353115727003
6,5,35,14,14,Romrod,36329,54.43,2710,1314,1396,50,0.0,2.0,1460.5,109.8,9.220618,50.714722,-82,0.9412607449856734
14,6,25,130,130,Elstra / Halštrow,1920,32.63,2702,1388,1314,83,0.0,2.0,1070.1013957730029,110.3,14.133453,51.222129,74,1.056316590563166
16,0,65,5052,14,Ebeleben,99713,44.54,2678,1349,1329,60,0.0,2.0,2115.6939266551562,110.9,10.58961,51.340997,20,1.0150489089541008
13,0,73,5360,93,Tribsees,18465,54.98,2669,1337,1332,49,0.0,2.0,1313.1572651355164,111.0,12.800798,54.141165,5,1.0037537537537538
15,0,84,5051,15,Bad Bibra,6647,49.77,2635,1326,1309,53,0.0,2.0,688.0,110.7,11.478438,51.14347,17,1.0129870129870129
13,0,76,5664,20,Brüel,19412,27.21,2626,1300,1326,97,0.0,2.0,1362.9072651355164,111.0,11.709013,53.770686,-26,0.9803921568627451
12,0,70,5009,325,Putlitz,16949,119.68,2624,1333,1291,22,0.0,2.0,1499.517249694436,110.7,12.043185,53.249052,42,1.032532920216886
12,0,70,5001,8,Bad Wilsnack,19336,79.38,2588,1224,1364,33,0.0,2.0,1404.267249694436,110.7,11.948256,52.954958,-140,0.8973607038123167
16,0,74,5005,116,Schkölen,7619,53.43,2586,1339,1247,48,0.0,2.0,982.0,110.9,11.821689,51.041988,92,1.0737770649558942
9,4,76,184,184,Wallenfels,96346,45.65,2568,1282,1286,56,0.0,2.0,2452.153072733723,110.5,11.471178,50.268421,-4,0.9968895800933126
15,0,89,5052,5,Alsleben (Saale),6425,23.7,2564,1207,1357,108,0.0,2.0,1459.517249694436,110.7,11.67745,51.700463,-150,0.8894620486366986
8,1,17,5006,61,Lauterstein,73111,23.31,2564,1270,1294,110,0.0,2.0,2349.0,109.5,9.861873,48.710289,-24,0.98145285935085
1,0,54,33,33,Friedrichstadt,25840,4.02,2555,1195,1360,636,0.0,2.0,2864.806349449769,109.4,9.087943,54.37346,-165,0.8786764705882353
8,4,37,5002,101,Scheer,72516,18.72,2544,1297,1247,136,0.0,2.0,2426.8321879301366,109.5,9.29442,48.072852,50,1.0400962309542903
12,0,63,5302,88,Friesack,14662,84.03,2537,1268,1269,30,0.0,2.0,1333.767249694436,110.7,12.579825,52.73771,-1,0.9992119779353822
9,4,72,5417,118,Betzenstein,91282,51.84,2529,1273,1256,49,0.0,2.0,1867.0,110.5,11.418135,49.682387,17,1.0135350318471337
12,0,69,5918,696,Ziesar,14793,67.96,2516,1237,1279,37,0.0,2.0,1712.954749694436,110.7,12.327259,52.222278,-42,0.9671618451915559
16,0,68,5006,42,Rastenberg,99636,35.52,2506,1265,1241,71,0.0,2.0,2167.0689266551562,110.9,11.328576,51.198795,24,1.0193392425463337
12,0,61,5114,164,Golßen,15938,63.68,2505,1266,1239,39,0.0,2.0,2400.0,110.7,13.576087,51.91603,27,1.0217917675544794
16,0,64,5001,4,Bad Tennstedt,99955,27.42,2504,1235,1269,91,0.0,2.0,2150.5064266551562,110.9,10.838775,51.153642,-34,0.9732072498029944
14,5,21,330,330,Jöhstadt,9477,49.69,2495,1270,1225,50,0.0,2.0,1231.6638957730029,110.3,13.089925,50.514439,45,1.036734693877551
12,0,73,5304,189,Gartz (Oder),16307,61.88,2452,1212,1240,40,0.0,2.0,1508.0,110.7,14.388886,53.2087,-28,0.9774193548387097
15,0,85,5051,365,Wegeleben,38828,51.77,2446,1224,1222,47,0.0,2.0,1889.767249694436,110.7,11.17357,51.884625,2,1.0016366612111294
8,3,36,5006,79,Schönau im Schwarzwald,79677,14.72,2417,1193,1224,164,0.0,2.0,2559.1446879301366,109.5,7.894621,47.803346,-31,0.9746732026143791
16,0,75,131,131,Gefell,7926,45.22,2415,1217,1198,53,0.0,2.0,1353.9439266551562,110.9,11.859201,50.438394,19,1.0158597662771285
15,0,84,5054,375,Osterfeld,6721,27.61,2412,1237,1175,87,0.0,2.0,1099.5,110.7,11.98731,51.076521,62,1.0527659574468085
1,0,61,5153,55,Krempe,25361,3.38,2411,1195,1216,713,0.0,2.0,2883.493849449769,109.4,9.493561,53.812422,-21,0.9827302631578947
15,0,85,5051,285,Schwanebeck,39397,32.62,2402,1174,1228,74,0.0,2.0,1893.954749694436,110.7,11.219229,51.936468,-54,0.9560260586319218
14,7,30,5303,90,Dommitzsch,4880,30.44,2400,1200,1200,79,0.0,2.0,1079.5,110.3,12.883596,51.639733,0,1.0
12,0,62,5209,445,Schlieben,4936,78.65,2397,1176,1221,30,0.0,2.0,1425.454749694436,110.7,13.471073,51.697732,-45,0.9631449631449631
6,5,35,6,6,Grebenau,36323,55.34,2394,1209,1185,43,0.0,2.0,1789.9097033712096,109.8,9.474834,50.743167,24,1.0202531645569621
9,3,76,5344,160,Schönsee,92539,50.28,2391,1220,1171,48,0.0,2.0,1410.0,110.5,12.547467,49.510012,49,1.0418445772843723
8,3,35,5001,1,Aach,78267,10.68,2384,1198,1186,223,0.0,2.0,2547.5196879301366,109.5,8.851043,47.8428,12,1.0101180438448567
9,3,74,5331,147,Pleystein,92714,42.4,2383,1186,1197,56,0.0,2.0,2332.965572733723,110.5,12.409987,49.645547,-11,0.9908103592314118
3,3,58,5402,18,Rethem (Aller),27336,34.08,2382,1201,1181,70,0.0,2.0,1687.0,110.0,9.428854,52.768678,20,1.0169348010160881
14,5,21,5130,520,Schlettau,9487,21.22,2322,1135,1187,109,0.0,2.0,1325.2888957730029,110.3,12.952013,50.559371,-52,0.9561920808761584
9,6,75,144,144,Mainbernheim,97350,12.21,2292,1141,1151,188,0.0,2.0,2489.403072733723,110.5,10.218579,49.708023,-10,0.9913119026933102
15,0,84,5051,125,Eckartsberga,6648,35.97,2275,1137,1138,63,0.0,2.0,1125.5,110.7,11.561354,51.122573,-1,0.9991212653778558
13,0,73,5353,27,Garz/Rügen,18574,65.91,2264,1106,1158,34,0.0,2.0,1260.0947651355164,111.0,13.352371,54.316745,-52,0.9550949913644214
7,1,41,5011,68,Katzenelnbogen,56368,9.18,2261,1062,1199,246,0.0,2.0,2364.2847033712096,109.8,8.00614,50.258747,-137,0.8857381150959133
14,6,26,420,420,Ostritz,2899,23.48,2249,1097,1152,96,0.0,2.0,851.0,110.3,14.93139,51.014115,-55,0.9522569444444444
8,4,15,5006,34,Hayingen,72534,63.37,2215,1095,1120,35,0.0,2.0,2128.3321879301366,109.5,9.475391,48.274365,-25,0.9776785714285714
13,0,72,5259,85,Rerik,18230,34.22,2192,1031,1161,64,0.0,2.0,1338.1572651355164,111.0,11.697671,54.125959,-130,0.8880275624461671
16,0,68,5002,14,Gebesee,99189,24.08,2168,1076,1092,90,0.0,2.0,1521.0,110.9,10.926862,51.082589,-16,0.9853479853479854
16,0,75,46,46,Hirschberg,7927,24.13,2168,1085,1083,90,0.0,2.0,1359.3189266551562,110.9,11.818713,50.406073,2,1.0018467220683287
9,6,73,5637,123,Fladungen,97650,46.34,2166,1100,1066,47,0.0,2.0,2216.840572733723,110.5,10.144596,50.522474,34,1.0318949343339587
8,4,37,5001,114,Veringenstadt,72519,31.25,2146,1054,1092,69,0.0,2.0,1802.0,109.5,9.214018,48.178302,-38,0.9652014652014652
12,0,60,5011,176,Oderberg,16248,36.12,2143,1084,1059,59,0.0,2.0,1446.642249694436,110.7,13.925103,52.809713,25,1.0236071765816808
6,6,35,17,17,Rosenthal,35119,51.55,2137,1076,1061,41,0.0,2.0,1741.3472033712096,109.8,8.867967,50.97462,15,1.0141376060320453
8,1,17,5007,58,Wiesensteig,73349,23.41,2102,1086,1016,90,0.0,2.0,2199.0,109.5,9.625129,48.561947,70,1.0688976377952757
14,6,28,5219,210,Königstein/Sächs. Schw.,1824,27.05,2101,1049,1052,78,0.0,2.0,1043.1638957730029,110.3,14.108678,50.91015,-3,0.997148288973384
12,0,70,5006,280,Meyenburg,16945,50.71,2090,1052,1038,41,0.0,2.0,1548.954749694436,110.7,12.31074,53.247396,14,1.0134874759152215
12,0,69,5910,448,Niemegk,14823,45.11,2069,1044,1025,46,0.0,2.0,2074.0,110.7,12.844257,52.145867,19,1.0185365853658537
12,0,66,5606,240,Ortrand,1990,7.36,2057,959,1098,279,0.0,2.0,1578.517249694436,110.7,13.724272,51.378633,-139,0.8734061930783242
14,5,21,440,440,Oberwiesenthal,9484,40.03,2045,1007,1038,51,0.0,2.0,1334.5,110.3,12.969165,50.419392,-31,0.9701348747591522
12,0,70,5005,244,Lenzen (Elbe),19309,96.2,2038,982,1056,21,0.0,2.0,1505.017249694436,110.7,11.601957,53.074161,-74,0.9299242424242424
14,5,21,5130,510,Scheibenberg,9481,9.0,2038,1008,1030,226,0.0,2.0,862.0,110.3,12.912503,50.54137,-22,0.9786407766990292
16,0,73,106,106,Leutenberg,7338,57.52,2027,1025,1002,35,0.0,2.0,1296.3189266551562,110.9,11.45136,50.564882,23,1.0229540918163673
3,2,57,5407,33,Sachsenhagen,31553,15.47,2005,1002,1003,130,0.0,2.0,1564.0,110.0,9.294945,52.398326,-1,0.9990029910269193
7,3,36,5008,58,Lauterecken,67742,8.89,1996,963,1033,225,0.0,2.0,2339.2222033712096,109.8,7.647541,49.669273,-70,0.9322362052274927
16,0,71,5008,53,Magdala,99441,20.58,1987,994,993,97,0.0,2.0,1932.0,110.9,11.476036,50.919196,1,1.001007049345418
16,0,70,5002,43,Plaue,99338,22.69,1978,973,1005,87,0.0,2.0,2204.8814266551562,110.9,10.899211,50.779512,-32,0.9681592039800995
8,1,27,5004,47,Langenburg,74595,31.4,1934,1004,930,62,0.0,2.0,2374.5,109.5,9.849831,49.253622,74,1.0795698924731183
9,6,77,177,177,Rieneck,97794,26.19,1932,954,978,74,0.0,2.0,2416.090572733723,110.5,9.648272,50.093154,-24,0.9754601226993865
9,4,76,5433,180,Teuschnitz,96358,34.25,1927,936,991,56,0.0,2.0,975.5,110.5,11.413805,50.424693,-55,0.9445005045408678
9,6,75,5618,149,Marktsteft,97342,10.51,1925,998,927,183,0.0,2.0,2385.215572733723,110.5,10.135151,49.696729,71,1.0765911542610571
12,0,61,5108,492,Teupitz,15755,48.15,1896,937,959,39,0.0,2.0,3116.5,110.7,13.637041,52.152793,-22,0.9770594369134515
16,0,73,5005,28,Gräfenthal,98743,36.42,1878,923,955,52,0.0,2.0,2168.8189266551562,110.9,11.307918,50.525286,-32,0.9664921465968587
9,4,75,5431,165,Schauenstein,95197,26.66,1878,932,946,70,0.0,2.0,1223.5,110.5,11.740779,50.277606,-14,0.985200845665962
7,3,36,5008,105,Wolfstein,67752,13.75,1874,918,956,136,0.0,2.0,2282.8784533712096,109.8,7.613261,49.603527,-38,0.9602510460251046
7,3,39,5001,3,Bacharach,55422,23.35,1837,910,927,79,0.0,2.0,2083.0,109.8,7.765023,50.060158,-17,0.9816612729234089
12,0,73,5303,85,Brüssow,17326,101.81,1827,932,895,18,0.0,2.0,1399.704749694436,110.7,14.126496,53.39961,37,1.041340782122905
8,1,25,5007,103,Widdern,74259,25.23,1825,955,870,72,0.0,2.0,2397.5,109.5,9.421596,49.318041,85,1.0977011494252873
13,0,75,5556,107,Penkun,17328,78.87,1815,887,928,23,0.0,2.0,1279.4072651355164,111.0,14.23566,53.297789,-41,0.9558189655172413
9,5,74,5527,160,Velden,91235,21.34,1813,920,893,85,0.0,2.0,2087.5,110.5,11.523338,49.596327,27,1.0302351623740202
8,4,37,5001,47,Hettingen,72513,46.06,1803,921,882,39,0.0,2.0,2293.3634379301366,109.5,9.234626,48.219073,39,1.0442176870748299
13,0,73,5360,7,Bad Sülze,18334,26.67,1796,917,879,67,0.0,2.0,1389.0,111.0,12.65907,54.109956,38,1.043230944254835
13,0,71,5153,109,Neukalen,17154,47.97,1747,879,868,36,0.0,2.0,1293.5947651355164,111.0,12.790764,53.822436,11,1.012672811059908
13,0,75,5562,137,Usedom,17406,39.06,1725,844,881,44,0.0,2.0,2167.0,111.0,13.928004,53.946939,-37,0.9580022701475596
9,5,71,5506,189,Ornbau,91737,15.16,1719,883,836,113,0.0,2.0,2304.246822733723,110.5,10.656504,49.176443,47,1.05622009569378
14,5,22,5129,520,Sayda,9619,35.3,1697,861,836,48,0.0,2.0,710.0,110.3,13.407333,50.808848,25,1.0299043062200957
16,0,75,5013,88,Ranis,7389,10.57,1679,818,861,159,0.0,2.0,1358.2251766551562,110.9,11.642483,50.680752,-43,0.9500580720092915
9,6,79,5654,182,Röttingen,97285,27.21,1661,846,815,61,0.0,2.0,1961.5,110.5,9.969683,49.510312,31,1.038036809815951
16,0,73,5005,46,Lehesten,7349,35.94,1614,833,781,45,0.0,2.0,1199.2251766551562,110.9,11.448099,50.475717,52,1.0665813060179257
12,0,63,5309,260,Rhinow,14728,31.66,1597,782,815,50,0.0,2.0,1509.0,110.7,12.375881,52.754595,-33,0.9595092024539877
16,0,66,47,47,Oberhof,98559,23.4,1592,781,811,68,0.0,2.0,2246.6001766551562,110.9,10.724059,50.706347,-30,0.9630086313193588
7,2,32,5005,88,Neuerburg,54673,10.17,1561,786,775,153,0.0,2.0,1577.5,109.8,6.332175,50.064696,11,1.0141935483870967
9,6,76,5632,158,Stadtprozelten,97909,10.87,1555,805,750,143,0.0,2.0,2368.809322733723,110.5,9.408401,49.783331,55,1.0733333333333333
14,6,28,5221,370,Stadt Wehlen,1829,10.85,1549,793,756,143,0.0,2.0,1693.5,110.3,14.033828,50.957282,37,1.0489417989417988
12,0,64,5408,84,Buckow (Märkische Schweiz),15377,14.42,1503,723,780,104,0.0,2.0,1467.048499694436,110.7,14.073102,52.568175,-57,0.926923076923077
13,0,75,5551,74,Lassan,17440,28.21,1491,736,755,53,0.0,2.0,1825.0,111.0,13.862341,53.923399,-19,0.9748344370860927
7,2,31,5008,80,Manderscheid,54531,10.06,1476,685,791,147,0.0,2.0,2156.0034533712096,109.8,6.844901,50.109768,-106,0.865992414664981
15,0,90,5051,10,Arneburg,39596,31.01,1447,710,737,47,0.0,2.0,1228.5,110.7,12.002138,52.675249,-27,0.9633649932157394
16,0,76,5056,29,Hohenleuben,7958,9.53,1442,814,628,151,0.0,2.0,1321.2251766551562,110.9,12.051165,50.711787,186,1.2961783439490446
7,3,40,5008,211,Hornbach,66500,13.34,1432,717,715,107,0.0,2.0,1457.5,109.8,7.369616,49.186042,2,1.0027972027972027
9,4,79,5443,127,Hohenberg a.d.Eger,95691,15.66,1421,708,713,91,0.0,2.0,2392.934322733723,110.5,12.222982,50.096856,-5,0.9929873772791024
9,6,79,5644,114,Aub,97239,17.54,1403,724,679,80,0.0,2.0,2294.5,110.5,10.06413,49.552013,45,1.0662739322533137
15,0,83,5054,355,Kroppenstedt,39397,38.69,1397,687,710,36,0.0,2.0,1880.485999694436,110.7,11.219229,51.936468,-23,0.967605633802817
13,0,73,5355,24,Franzburg,18461,15.2,1367,667,700,90,0.0,2.0,1466.5,111.0,12.877572,54.186968,-33,0.9528571428571428
13,0,73,5355,76,Richtenberg,18461,15.67,1351,667,684,86,0.0,2.0,1369.6572651355164,111.0,12.877572,54.186968,-17,0.9751461988304093
12,0,61,5113,308,Lieberose,15868,73.03,1329,662,667,18,0.0,2.0,1608.5,110.7,14.354101,51.991607,-5,0.992503748125937
7,1,41,5009,121,Sankt Goarshausen,56346,7.06,1284,650,634,182,0.0,2.0,2332.8784533712096,109.8,7.663861,50.206715,16,1.025236593059937
14,6,28,5202,230,Liebstadt,1825,37.37,1268,655,613,34,0.0,2.0,1430.5,110.3,13.856393,50.863515,42,1.068515497553018
6,6,34,23,23,Schwarzenborn,34639,26.9,1209,649,560,45,0.0,2.0,1753.4097033712096,109.8,9.44575,50.909926,89,1.1589285714285715
9,3,74,5327,140,Neustadt am Kulm,95514,20.3,1135,557,578,56,0.0,2.0,2378.3252237921697,110.5,11.834476,49.826258,-21,0.9636678200692042
16,0,74,5011,65,Orlamünde,7768,7.47,1073,545,528,144,0.0,2.0,1696.5,110.9,11.588507,50.801709,17,1.0321969696969697
15,0,88,5051,340,Schraplau,6279,7.06,1073,523,550,152,0.0,2.0,1679.2635347102114,110.7,11.568642,51.425982,-27,0.9509090909090909
9,4,77,5437,129,Kupferberg,95362,8.29,1058,529,529,128,0.0,2.0,2415.3925430101663,110.5,11.576725,50.139459,0,1.0
16,0,65,5002,12,Clingen,99718,10.75,1051,513,538,98,0.0,2.0,1128.0,110.9,10.944013,51.228102,-25,0.9535315985130112
7,3,33,5007,54,Obermoschel,67823,10.15,1049,514,535,103,0.0,2.0,1511.0,109.8,7.724989,49.73456,-21,0.9607476635514018
9,4,75,5428,146,Lichtenberg,95192,9.47,1023,506,517,108,0.0,2.0,1072.0,110.5,11.675154,50.382765,-11,0.9787234042553191
9,6,77,5621,181,Rothenfels,97851,12.07,1012,509,503,84,0.0,2.0,2027.0,110.5,9.589787,49.890749,6,1.0119284294234592
7,2,32,5008,70,Kyllburg,54655,4.62,981,520,461,212,0.0,2.0,1449.0,109.8,6.573687,50.030841,59,1.1279826464208242
15,0,90,5051,610,Werben (Elbe),39615,53.12,957,494,463,18,0.0,2.0,1163.5,110.7,11.982379,52.860907,31,1.0669546436285098
15,0,84,5054,470,Stößen,6667,7.29,908,431,477,125,0.0,2.0,1118.0,110.7,11.966732,51.200338,-46,0.9035639412997903
12,0,61,5108,328,Märkisch Buchholz,15748,24.86,863,439,424,35,0.0,2.0,2469.5,110.7,13.761856,52.109763,15,1.0353773584905661
15,0,90,5052,445,Sandau (Elbe),39524,18.58,829,395,434,45,0.0,2.0,1204.5,110.7,12.112871,52.748794,-39,0.9101382488479263
7,1,41,5009,69,Kaub,56349,13.05,828,425,403,63,0.0,2.0,1854.5,109.8,7.765045,50.089294,22,1.054590570719603
16,0,75,5013,127,Ziegenrück,7924,8.25,646,311,335,78,0.0,2.0,940.5,110.9,11.76822,50.600207,-24,0.9283582089552239
3,3,54,5403,21,Schnackenburg,29493,23.7,518,258,260,22,0.0,2.0,1193.5,110.0,11.566732,53.037209,-2,0.9923076923076923
16,0,71,5053,61,Neumark,99439,8.67,486,261,225,56,0.0,2.0,763.5,110.9,11.210999,51.051754,36,1.16
16,0,69,5004,52,Ummerstadt,98663,15.73,457,232,225,29,0.0,2.0,1730.5,110.9,10.622424,50.328646,7,1.031111111111111
1,0,59,5920,2,Arnis,24399,0.45,273,131,142,607,0.0,2.0,3486.0,109.4,9.932332,54.630563,-11,0.9225352112676056
